11111111111111111111111111111111111111111111111111
1dddddddddddddddddddddddddddddddddddddddddddddddd1
1d1111111111111111111111111111111111111111111111d1
1d1A00100000000000000100000100200020002000000od1d1
1d111010000001000000010%000100202020202000000oo1d1
1d1d1010000001000000010000d100202020202000000001d1
1d1010000000011110000111111110202020202000000001d1
1d1010100000011#10000000000010202020202000000001d1
1d101010000001M010000000000010002020202000000001d1
1d1010100000011111111111211111102020202000000001d1
1d1010100000040000000000000000002000200000000001d1
1d1010111111111111111101111011111111111111111111d1
1d101°10000000000000010000001d002020200001000001d1
1d1010100000000000000111111112200202000001000@01d1
1d1010100000000000000000000020202020211101100001d1
1d1010000000000000004444400000020202001000100001d1
1d1010100000000000004>2<4000020002220010^0100001d1
1d1010100000000000004444400000202000001000100001d1
1d101010!000000000000000000000020000001111100001d1
1d1010100000000000000000000000000000000000000001d1
1d1011111111111111111111111111111111111111111101d1
1d1000000000000000000000000000000000000000000001d1
1d1111010000000000000000000000000000000000000001d1
1d1000010000000000000000000000000000000000000001d1
1d1000010000000000000000000000000000000000000001d1
1d1000011111111111111111111111111111111111101101d1
1d1K000T000000000000000000000000000000000000M101d1
1d11111111111111111111111111111111111111111011D1d1
1dddddddddddddddddddddddddddddddddddddddddddddddd1
11111111111111111111111111111111111111111111111111