11111111111111111111111111111111111111111111111111
1A000000000000000000000000000000000000000000000001
11111111111111111111111111111111111111111111111101
1°1000000000000000000000000000000000000000000d1101
1°100000000000000000000000000000000000000000011001
1°10!000000000000000000000000000000000000000110001
1°100000000000000000000000000000000000000001100001
10111111111111111111111111111111111111111111000001
M0000000000000000000000000000000000000000000000001
10100000000000000000000000000000000000000011111111
101000000000000000000000000000000000000001>00000d1
10100000000000000000000000000000000000001100111101
10100000000000000000000000000000000000011000000101
10100000000000000000000000000000000000110000000101
10100000000000000000000000000000000001100000000101
10100000000000000000000000000000000011000000000101
1010@0$0^00000000000000000000000000110000000000101
10100000000000000000000000000000001110000000011101
11111111111111111111111111111111111>D0000000010001
1d000000000000000000000000000000001111000000010111
10000000000000000000000000000000001TK00000000040d1
10000000000000000000000000000000001111000000000011
10000000000000000000000000000000001000000000000001
10000000000000000000000000000000001000000000000001
10000000000000000000000000000000001000000000000001
10000000000000000000000000000000001011111111111111
10000000000000000000000000000000001000000000000001
10000000000000000000000000000000#01000000000000%01
10000000000000000000000000000000001000000000000001
11111111111111111111111111111111111111111111111111