11111111111111111111111111111111111111111111111111
1111100000002020000000020000000200d100000000011111
1111100010000222221000200000000202010000000A011111
11111002000000020210002000000000222100000000011111
11111020000222222212220000002000000100000000011111
11111010020000000010202000000002000100000000011111
11111000100000000010000000000000000100000000011111
11111000000000000010000000002000000100000000011111
11111000000000000010002000000020000100000000011111
11111000000000000010000000000000000100000000011111
11111000000000000010020000002002000100000000011111
11111002002000000010000000000000222100000000011111
11111220200000002010010200000202222100000000011111
11111002000200020210001000000200200100000000011111
11111002000000200d10000000000022200200000000011111
11111011111111111111111111111111111111111111111111
1111100000000000001d002000000000000200000000011111
11111222222222222012020222000222000100000000011111
11111000000000000010200000000000000100000000011111
11111022222222222210202220002000200100000000011111
11111022222222222210200000020002000100000000011111
11111000000000000010002202200000200100000000011111
11111220020002020010022020000020000100000000011111
11111020002220000010200000000200020100000000011111
11111000000020000012000002002000002100000000011111
11111020020000200010000000220002000100000000011111
11111000000000000010000000000002200100000000011111
1111122222222222201022020202202000010000000T011111
11111d00000000000002000000200000000100000000011111
11111111111111111111111111111111111111111111111111