11111111111111111111111111111111111111111111111111
10001111111111111111111111111111111111111111110001
10A00000000000000000000000000000000000000000000T01
10001010101111111111111111111111111111110101010001
11111010101d00000002021d110000D0000000010101011111
M0000010101222200200001d1100001000000001010100000<
10000010101002020202001d11000010000000010101000001
10000010101022022000201d11d00010000000010101000001
1!000010101202000202001011111110000000010101000001
1d000010101000200002001011000000000000010101d00001
1111111010100200202000101>210000000000010101111111
100000001010000020002010110100000000000101002000o1
1000000010122002220222101>0100000000000101000000d1
10000000101002220020001011010000000000010100202201
1000000010100200222022101>010000000000010102200021
10000000101020000002000011010000000000010100202021
10°00000101111111111111011010000000000010100222201
1d000000101KKKK00000004011000000000000010100000001
11111111101111111111111411011111111111110111111111
10000000000000000000000011000000000000000000000001
10000000000000000000000011000000000000000000000001
10000000000000000000000011000000000000000000000001
10000000000011111111111111011111111111111111111101
1000101000001&0000000000d101d00000000000000000*101
10001#10000011111111^11111011111111111111111111101
10001110000000000001110011000000000000000000000001
10000000001110000000000011000000000000011100000001
10000000001$1000000000001100000000000001%100000001
1d0000000000000000000000MM0000000000000000000000K1
11111111111111111111111111111111111111111111111111