A001000000000000000000000000000000000000000000000d
00010100000000000000000000000000000000000000000000
0001@100000000000000000000000000000000000000000000
00011111111100000000000000000000000000000000000000
0001!1#1%1&100000000000000000000000000000000000000
00000000000100000000000000000000000000000000000000
11111111111111111111111111111111111111111111111111
00000000000000000000000000000000000000000000000000
00000000000000000000000000000000000000000000000000
00000000000000000000000000000000000000000000000000
00000000000000000000000000000000000000000000000000
$100000000000000000000000000000000000000000000000d
11111111111111111111111111111111111111111111111111
00000000000000000000000000000000000000000000000000
00000000000000000000000000000000000000000000000000
00000000000000000000000000000000000000000000000000
00000000000000000000000000000000000000000000000000
^100000000000000000000000000000000000000000000000d
11111111111111111111111111111111111111111111111111
0000000000000000000000000000000000000000000000000d
00000000000000000000000000000000000000002202000000
00000000000000000000000000000000000000000020020200
00000000000000000000000000000000000000020002002020
*1000000000000000000000000000000000000200000200000
11111111111111111111111111111111111111111111111110
20000020020020000000200020000000000000000000000000
02022002200000020022022020200200200002000002000002
00220200202202222000000202222222022020020200200222
00200020000020202000020000022022000220002000020200
2200000202020000022000220000000000200000000000000T