K0000000111111111111111100000000000000111110000111
000000!0111111111111111100000000000000111110000111
0000000011111111111111110@000002000000012112T00111
00040000111111111111111100000000000000000022000111
004A4000111000000111111100000002000000111112000111
00040000111011010111111100000002000000221110000111
00000000111011010111111100000002000000011110000111
00000000111000000111111100020002000000111110000111
0000000d111111011111111100000000000000211110000111
0000000d111111011111111100000200000000111110000111
0000000d111000001111111100000000000000111110000111
0000000d111011101111111100000002000000111110000111
00000000111011101111111100020000000000111110000111
00002000111000001111111100000000002000111110000111
220200000110111011111111000000°0000000111110000111
101D1111000011101111111100000000000000111110000111
00000100011000001111111100200000002000111110000111
22222100011101111111111100000000000000111110000111
02020111111101111111111100000020000000111110000111
00000000111101111111111100000000020000111110000111
00000000111000111000011100020000000000111110000111
00000000111010111011011100000000000000111110000111
00000000111000000011000000002000200000111110000111
00000000<11111111011011100000000000000111110000111
0000000011111111100001110000000000000o111110000111
000M0000111111111111111>00000000000000111110000111
00000000111111111111111111111111111111111110000111
00000000111111111111111100000000000000000000000111
0000000000000000000000000000000000000M111110000111
11111111111111111111111111111111111111111111111111