A0000000000000000000000000000000000000000000000000
01111111111111111111111101111111111111111111111110
01d0000002210000000000d1010000000000d1000000000d10
01220000200100000000000101000000000001001000000010
01002222022100000000000101000000000001M00000000010
010022200001000oooo0000101000000000001000000000010
01020002020100000000000101000000000001000000000010
01200000200100000000000101000000000001M00000000010
01200000020100000000000101000000000001000000000010
01022002202100000000000101>00000000001010000200010
01000220000100000000000101>00000000001000000000010
01000200022100000000000101>00000000001000004000010
01022020200100000000000101>00000000001000000000010
01111D1111111111D1111111011111D111111111111D111110
00000000000000000000000000000000000000000000000000
01111101111111114111111101111011111111111011111110
0100000200K100000000000101000000100011000000000010
010000022001000000000001010001!1100011000000000010
01000002020100000000000101000001100011000000000010
01000002002100000000000101001@11M000M1000200000010
0122222222210000000000010100000110%011M00000000000
00000020000111111110000101001#11M000M1000000000010
01000020000100000000000400000001111111000000000010
01000020000101111100000101111^11100011000000000010
0100002000010100000000010100000011$111000020000010
01000020000101000000000101000000100011000000000010
0100222000010100000000010100000010K011000000000010
010020200001K1000000000101000000100011K00000000M10
01111011111111111141111101111101111111111101111110
0000000000000000000000000000000000000000000000000T