00000000000000000000000000000000111111111111111111
00000111001111000111100001110000111111111111111111
000010001010001001000100100010001A0000000000000011
00021000101000120100010010001000100000000000000011
00001000101001000100100010001000100000000000000011
00001111101110000111000010001200100000444400000011
00001000101001100100110010001000100000444400000011
00001000121000010102001010001000100000444400000011
20001000101000010100001010001000100000444400000011
00001200101111100111110001110020100000444400000011
00000000000000000000002000000000100000000000000011
11111111111111111111111111111111100000000000000011
11000000000000000000000000000000000000000000000011
11000000000000000000000000000000000000000000000011
11000000000000000000000000000000000000000000000011
11111101111111111111111011111111111111011111111111
11111101111111111111111011111110000000011111111111
11111101111111111111111011111110111111111111111111
11111101111111111111111011111110000000011111111111
11111101111111111111111011111111111111011111111111
11111101111111111111111011111110000000011111111111
11111101111111111111111011111110111111111111111111
11111101111111111111111011111110000000011111111111
11111101111111111111111011111111111111011111111111
11@00001111111111111111#11111111111111000000000!11
11111111111111111111111111111111111111111111111111
11000000000000000000002220000000000000000000000011
11000000000000000000002220000000000000000000000011
11111111111111111111111111111111111111111111111111
11111111111111111111111111111111111111111111111111