4:20 "Slarti"
08 05  07 05
 0 0 0 0 0 0 0 0 0 0 0 0 0 0 0 0
 0n0n0n0l2n0n0o1n0n0r1 0 0 0 0 0
 0n0 0 0 0 0 0 0 0 0n0 0 0 0 0 0
 0n0 0 0 0 0 0z0k0l2c0n0n0n0n0 0
 0u2 0 0 0 0 0 0 0 0o3 0 0 0n0 0
 0n0 0 0 0n0l4n0n0r4n0 0 0 0n0 0
 0n0 0 0 0u3 0 0 0 0 0 0 0 0o2 0
 0n0n0n0n0c0r2k1z0 0 0 0 0 0n0 0
 0 0 0 0 0n0 0 0 0 0 0 0 0 0n0 0
 0 0 0 0 0l1n0n0u1n0n0r2n0n0n0 0
 0 0 0 0 0 0 0 0 0 0 0 0 0 0 0 0
