0:45 "Sönke Tesch"
12 02  07 05
w4w2w2w2w4w2w2w2w4w1w1w1w1w1w2w1
w3w2w3w4w2w2w2w2w4w2w3w1w1n0w2w4
w4w2n0w1w1w1w1w1n0w1w3w1n0w3w4w1
w3w2w4w2w3w3w2w2w4w3w4w1w4w3w4w1
w3w3w4w2w3w3w4w1w1w3w1w3w4n0c0n0
w4w3w4w2w3w3w4n0z0w3w4w1w1w3w4w4
w2w3n0w1w3w1w2w2w2w3w3w4w4w3w4w4
w2w3w4w3w3n0w2w2n0w2w2w2w2w3w4w4
w3w1w4w1w1w3w3w3w3w1w2w4w1w1c0w1
w3w1n0w2w2n0w3w1w1w1w1w4w1w1w4w1
w1w3w1w3w3w3w3w1w1w1w3w1w1s1r3w3
00 00  16 11
a1w1w2w2w4w2w2w2w2w2w2w4w2w2w1a2
w4w1w2w2w2c0w2w2w4w4w1n0w1w1w1w1
w4w2w2w3w4w3w1w4w4w4w1w4w1w1w2w2
w4w4w4w3w4n0w1w1c0w1w1w4w1w2w4w1
w2w2w2w3w2w4w2w2c0w2w2c0w2w2w2w4
w1w2w4w4w2w2w3w2z0w1w1c0w1w1w1w1
w4w4w4w2w4w2w3w4w1w1w1w4w3w3w2w3
w2w2w2w4w4w4w3w4w4w3w1c0w1w3w3w3
w3w3w3w2w2w2w3w4w1w3w3w4w3w3w3w2
w3w4w1w4w4w1w4w4w4w4w3w4w3w2w2w3
w3w1w3w1w1w3w1w1w1w3w4w2w3e2l3e1
