1:30 "Slarti"
06 06  07 06
w4w1w1w4w4w1w1w2w2w2w2w4w1w2w4z0
w4w2w3w4w1w2w3w3w1w1w1w2w2w3w2w3
w4w3w1w1w2w3w2w2w2w4w3w1w3w4w1w1
w4 0 0 0w3 0w3w1 0w4 0w3w1w4 0w3
w4 0w4w2w3 0w2w3 0w4 0 0w3w1 0w3
w4 0 0w3w1 0w3w1 0w4 0w1 0w3 0w3
w4 0w2w2w3 0o1n0 0w4 0w2w4 0 0w3
w4 0w3w1w4w1 0 0w4w1 0w3w2w4 0w3
w4w2w4w3w1w3w1w1w1w2w2w3w1w2w4w3
w4w3w4w2w4w2w4w2w4w3w1w1w4w1w1w3
w2w3w2w3w2w3w2w3w2w2w2w3w2w2w2w3
