/* chicago levels */

"c-l1",
	0,0,1,	14,5,100,		13,5,120,		12,5,130,

"c-l2",
	2,2,0,	15,5,100,		13,5,120,		12,5,130,

"c-l3",
	1,1,2,	16,5,100,		13,5,120,		12,5,140,

"c-l4",
	0,0,3,	18,8,100,		18,7,120,		17,7,140,

"c-l5",

	2,2,1,	15,5,100,		12,5,120,		11,5,130,

"c-l6",
	1,1,2,	15,8,100,		11,8,120,		9,8,130

end
