10
10
##########
#5 6     #
# 7 8  k #
##=#######
## #     #
## # ### #
##A#  %# #
##A##### #
##  A A  #
##########
