20
20
####################
#                  #
#                  #
#  ############    #
#  #          #    #
#  #          #    #
#  #  ######  #    #
#  #  #FFFF#  #    #
#  #  # 5  #  #    #
#  #  #  6 #  #    #
#  #  # 7  #  #    #
#  #  #  8 #  #    #
#  #       #  #    #
#  #########  #    #
#             #    #
#             #    #
###############    #
#  $A$A$A$A$A$     #
#  $$A$A$A$A$$  %  #
####################
