MAX         02471000
MAX         02039000
MAX         00779500
MAX         00705000
MAX         00640000
MAX         00457000
MAX         00391500
