size 7x7
0 0 0 1 1 1 1
0 1 1 1 2 6 1
1 1 4 3 3 4 1
1 2 2 3 2 1 1
1 2 1 2 4 1 0
1 2 3 2 4 1 0
1 1 1 1 1 1 0