size 6x6
1 1 1 1 1 1
1 6 2 2 4 1
1 3 3 3 2 1
1 4 2 1 2 1
1 2 2 4 2 1
1 1 1 1 1 1