size 7x9
1 1 1 1 1 1 0 0 0
1 2 2 2 2 1 0 0 0
1 2 1 1 2 1 1 0 0
1 2 4 3 6 4 1 1 1
1 1 2 3 3 2 2 2 1
0 1 2 2 1 4 2 2 1
0 1 1 1 1 1 1 1 1