size 6x7
1 1 1 1 1 1 0
1 2 2 2 6 1 1
1 2 2 1 5 2 1
1 2 2 2 3 2 1
1 2 2 3 4 4 1
1 1 1 1 1 1 1