size 6x7
0 0 1 1 1 1 0
1 1 1 7 2 1 1
1 2 2 3 3 2 1
1 2 1 3 2 2 1
1 4 2 2 2 4 1
1 1 1 1 1 1 1