0000110000
0200110020
0000110000
0000110000
1111001111
1111041111
0000110000
0000110000
0200110020
0000110000
90