2100000002
2100000002
2100000002
2100000000
2100000000
2100040000
2100000000
2100000002
2100000002
2100000002
90
