A00000000A
0310000130
01A2002A10
0022112200
0001001000
0001041000
0022112200
01A2002A10
0310000130
A00000000A
90