>00000000A
0000000000
0022222200
0021111200
0021001200
4021001200
0021111200
0022222200
0000000000
A00000000>
70