0100?00010
0222222220
0010000100
0000000000
0001001000
0001041000
0000000000
0010000100
0222222220
01000>0010
91