3:=0000=;3
<3=0000=3<
<;310013:<
0012002100
0000000000
0000040000
0012002100
=;310013:=
=3<0000<3=
3:<0000<;3
90