0099009900
0000110000
0000000000
0000000000
9100000012
9100040012
0000000000
0000000000
0000110000
0099009900
90
