0000000000
0000000000
0000000000
0222222220
3111111113
0000040000
3222222223
0000000000
0000000000
0000000000
90
