0000000000
A00000000A
0000000000
0111111110
3111111113
0000040000
3111111113
0000000000
A00000000A
0222222220
90
