@02222220A
0001111000
0010000100
0101001010
0100000010
0110040110
0101111010
0010000100
0001111000
A02222220?
:1