0:00000010
100000000=
0000000000
0000000000
000;000000
000004:000
0000000000
0000000000
<000000001
01000000;0
40
