3300000033
3300000033
0091991900
0011111100
0091991900
0091941900
0011111100
0091991900
3300000033
3300000033
:0
