3000000000
0000000000
2>>>1>>>>>
2>>>1>>>>>
2>>>1>>>>>
2>>>14>>>>
2>>>1>>>>>
2>>>1>>>>>
0000000000
3000000000
:0
