>@@>00>00>
0>@@>00>00
00>@@>00>0
>00>00>00>
0100100100
0>>0>>0>>0
>1>1001>1>
0000040000
0000110000
0000000000
20
