0A222222AA
000000>012
00?0000021
0000000012
00000A0021
0000B04012
0000A00021
0000000012
000000>021
0000000012
:0