A00A00A00A
0000000000
2222222200
000000020A
2222220200
0000420200
222202020A
0002020200
2202020200
120202020A
60
