000000A00A
0000000000
2222222200
000000020A
2222220200
0000420200
2222020200
0002020200
2202020200
9202020200
60
