3@@@01@@@3
@3@@00@@3@
@@3@00@3@@
@@@3003@@@
0000000001
1000400000
@@@3003@@@
@@3@00@3@@
@3@@00@@3@
3@@@10@@@3
20
