9920?00299
9900000099
2010000102
0001001000
0000C20000
0000240000
0001001000
2010000102
9900000099
99200?0299
:0
