9000000002
=000000000
0000000000
0003003000
0000000000
0000040000
0003003000
0000000000
2222222200
9000000090
:1
