3333333333
0000000000
0000000000
0000000000
0AAAAAAAA0
D4>>>>>>>:
00000?0000
0000000000
0000000000
1111111111
60