size 6x8
0 1 1 1 1 1 1 0
1 1 2 2 4 2 1 1
1 2 2 2 3 3 6 1
1 2 1 4 2 3 2 1
1 2 2 4 1 2 2 1
1 1 1 1 1 1 1 1