1 34x31 RGHOST=29.5 ROGHOST=0 COGHOST=0 CGHOST=32.5 RFRUIT=12.5 CFRUIT=18 RTOP=29.5 RHERO=1.5 CHERO=1.5 RMSG=14 CMSG=4 RMSG2=14 CMSG2=19 ABOUT="Inspired by 'Apollo Pac' by Geoffrey Cooper/Imagen Corp. "
╔════════════════════════════════╗
║································║
║·╞═╦═══╦═══╦═══╦═══╦══════╡·╞╕┐·║
║···║···║···║···║···║·········││·║
║·╥·╨·╥·╨·╥·╨·╥·╨·╥·╨·╔════╡··││·║
║·║···║···║···║···║···║·······││·║
║·╠═══╩═══╩═══╩═══╩═══╝·╞═════╡│·║
║·║·■·························││·║
║·║·┌───────────┐·┌─┐·┌─┐·┌─┐·││·║
║·║·└───────────┘·└─┘·└─╘═╛─┘·││·║
║·║·■·························││·║
║·╚══════╡·╞═══════════╡·╞════╛┘·║
║································║
║·┌────────────┐·┌─────────────┐·║
║·│            │·│           ┌─╖·║
║·└────────────┘·└───────────┘·╨·║
║·········■······················║
║·╞═══════════════╗·┌─┐·┌─┐·┌──┐·║
║·················║·│ │·│ │·│  │·║
║·┌───────┐·╥·╞╕┐·║·╓─┘·│ │·│  │·║
║·└───────┘·║··││·║·║···└─┘·│  │·║
║···········╙──┘│·║·║·╥·····│  │·║
║·┌────┐·┌┐·└───┘·║·║·║·┌─┐·│  │·║
║·│    │·││·······║·║·║·│ │·│  │·║
║·└────┘·└╘═════╗·║·║·║·└─┘·│  │·║
║···············║·║·║·║·····│  │·║
║·┌╒╡·╞═════════╝·║·║·╨·┌─┐·│  │·║
║·││··············║·║···│ │·│  │·║
║·└╘══════════════╝·╨·╞═╛─┘·└──┘·║
║································║
╚════════════════════════════════╝
