1 28x24 RMSG=14 RMSG2=8 RTOP=9.5 ROGHOST=1.5 RGHOST=12 RFRUIT=14.5 RHERO=18.5 ABOUT="Inspired by Steven Goodwin's 'ASCII Pacman'"
╔════════════╕╒════════════╗
║············││············║
║·┌──┐·┌───┐·││·┌───┐·┌──┐·║
║■└──┘·└───┘·└┘·└───┘·└──┘■║
║··························║
║·╞══╡·┌┐·╞══╕╒══╡·┌┐·╞══╡·║
║······││····││····││······║
╚════╗·│╞══╡ └┘ ╞══╡│·╔════╝
     ║·││          ││·║     
     ║·││ ╔══≡≡══╗ ││·║     
═════╝·└┘ ║      ║ └┘·╚═════
      ·   ║      ║   ·      
═════╗·┌┐ ║      ║ ┌┐·╔═════
     ║·││ ╚══════╝ ││·║     
     ║·││          ││·║     
╔════╝·└┘ ╞══╕╒══╡ └┘·╚════╗
║············││············║
║·╞═╕┐·╞═══╡·└┘·╞═══╡·┌╒═╡·║
║■··││················││··■║
╠═╡·└┘·┌┐·╞══╕╒══╡·┌┐·└┘·╞═╣
║······││····││····││······║
║·╞════╛╘══╡·└┘·╞══╛╘════╡·║
║··························║
╚══════════════════════════╝
