3 28x32~4 READY="  READY!  " GAMEOVER="GAME  OVER" PLAYER1="PLAYER ONE" PLAYER2="PLAYER TWO" WALL_COLORS="\x07\x02\x0B" MORTAR_COLORS="\x02\x0B\x07" DOT_COLORS="\x0F" ROGHOST=2 RFRUIT=15.5,16.5,17.5 RTOP=9.5,10.5,11.5 RHERO=22.5,20.5,23.5 RMSG=15,16,17 RMSG2=9,10,11 ABOUT="Inspired by Bally's 'Baby Pac-Man' pinball machine" NOTE="this does not include a pinball simulator"
╔══════════════════════════╗
║··························║
║·┌───┐·┌──────────┐·┌───┐·║
║·│┌──┘·└────┐┌────┘·└──┐│·║
║·││·········││·········││·║
║·││·┌──┐·┌┐·││·┌┐·┌──┐·││·║
║·││·│  │·││·││·││·│  │·││·║
║■└┘·└─┐│·││·││·││·│┌─┘·└┘■║
║······││·└┘·└┘·└┘·││······║
╚════╗·││          ││·╔════╝
     ║·││ ╔══≡≡══╗ ││·║     
═════╝·└┘ ║      ║ └┘·╚═════
      ·   ║      ║   ·      
═════╗·┌┐ ║      ║ ┌┐·╔═════
     ║·││ ╚══════╝ ││·║     
╔════╝·││          ││·╚════╗
║······│└──┐ ┌┐ ┌──┘│······║
║·┌──┐·│┌──┘ ││ └──┐│·┌──┐·║
║·│  │·││····││····││·│  │·║
║·│  │·││·┌──┘└──┐·││·│  │·║
║·│  │·││·│      │·││·│  │·║
║·│┌─┘·└┘·└──────┘·└┘·└─┐│·║
║·││·········  ·········││·║
║■││·┌─────┐·┌┐·┌─────┐·││■║
║·└┘·└─────┘·││·└─────┘·└┘·║
║············││············║
║·┌┐·╔╗ ╔╗·┌─┘└─┐·╔╗ ╔╗·┌┐·║
║·││·║║ ║║·│    │·║║ ║║·││·║
║·└┘·║║ ║║·└────┘·║║ ║║·└┘·║
║····║║ ║║········║║ ║║····║
╚════╣║ ║╠════════╣║ ║╠════╝
     ║║»║║        ║║«║║     
╔══════════════════════════╗
║··························║
║·┌─────┐·┌──────┐·┌─────┐·║
║·└─────┘·│┌────┐│·└─────┘·║
║·········││····││·········║
║·┌─────┐·││·┌┐·││·┌─────┐·║
║·│┌────┘·└┘·││·└┘·└────┐│·║
║■││·········││·········││■║
║·││·┌──┐ ┌──┘└──┐ ┌──┐·││·║
║·└┘·└─┐│ └──────┘ │┌─┘·└┘·║
║······││          ││······║
╚════╗·││ ╔══≡≡══╗ ││·╔════╝
═════╝·└┘ ║      ║ └┘·╚═════
      ·   ║      ║   ·      
═════╗·┌┐ ║      ║ ┌┐·╔═════
╔════╝·││ ╚══════╝ ││·╚════╗
║······││          ││······║
║·┌──┐·│└──┐ ┌┐ ┌──┘│·┌──┐·║
║·│  │·│   │ ││ │   │·│  │·║
║·│  │·│┌──┘ └┘ └──┐│·│  │·║
║·└──┘·││····  ····││·└──┘·║
║······││·┌┐·┌┐·┌┐·││······║
║·┌──┐·││·││·││·││·││·┌──┐·║
║■│┌─┘·└┘·││·││·││·└┘·└─┐│■║
║·││······││·││·││······││·║
║·││·┌────┘│·││·│└────┐·││·║
║·││·└─────┘·└┘·└─────┘·││·║
║·││····················││·║
║·└┘·╔╗ ╔══════════╗ ╔╗·└┘·║
║····║║ ║          ║ ║║····║
╚════╣║ ║╔════════╗║ ║╠════╝
     ║║»║║        ║║«║║     
╔════════════╗╔════════════╗
║············║║············║
║·┌──┐·┌───┐·║║·┌───┐·┌──┐·║
║·│  │·│   │·║║·│   │·│  │·║
║·└──┘·└───┘·╚╝·└───┘·└──┘·║
║··························║
║·┌──┐·┌┐·┌──────┐·┌┐·┌──┐·║
║■└──┘·││·└──┐┌──┘·││·└──┘■║
║······││····││····││······║
╚════╗·│└──┐ ││ ┌──┘│·╔════╝
     ║·│┌──┘ └┘ └──┐│·║     
     ║·││          ││·║     
     ║·││ ╔══≡≡══╗ ││·║     
═════╝·└┘ ║      ║ └┘·╚═════
      ·   ║      ║   ·      
═════╗·┌┐ ║      ║ ┌┐·╔═════
     ║·││ ╚══════╝ ││·║     
     ║·││          ││·║     
     ║·││ ┌──────┐ ││·║     
╔════╝·└┘ └──┐┌──┘ └┘·╚════╗
║············││············║
║·┌┐·┌─────┐·││·┌─────┐·┌┐·║
║·││·└─────┘·└┘·└─────┘·││·║
║■││·········  ·········││■║
║·└┘·┌───┐·┌────┐·┌───┐·└┘·║
║····│   │·│    │·│   │····║
║·┌┐·└───┘·└────┘·└───┘·┌┐·║
║·││····················││·║
║·└┘·╔╗ ╔══════════╗ ╔╗·└┘·║
║····║║ ║          ║ ║║····║
╚════╣║ ║╔════════╗║ ║╠════╝
     ║║»║║        ║║«║║     
