6 33x23~4 RHERO=17.5,17.5,12.5,17.5,17.5,17.5 RFRUIT=17.5,17.5,12.5,17.5,17.5,17.5 RMSG=22 RMSG2=0 CMSG=13 CMSG2=13 READY=" READY!" GAMEOVER=" GONE  " PLAYER1=" P ONE " PLAYER2=" P TWO " RGHOST=15.5 ROGHOST=1 RTOP=13.5 WALL_COLORS="\x0C\x09" MORTAR_COLORS="\x09\x0C" DOT_COLORS="\x0F\x0F" ABOUT="Inspired by Nick Jones/Bubble Bus's 'Classic Muncher'"
┌───────────────────────────────┐
│┌─────────────┐ ┌─────────────┐│
││■ · · · · · ·│ │· · · · · · ■││
││ ┌───┐ ┌───┐ │ │ ┌───┐ ┌───┐ ││
││·│   │·│   │·│ │·│   │·│   │·││
││ └───┘ └───┘ └─┘ └───┘ └───┘ ││
││· · · · · · · · · · · · · · ·││
││ ┌───┐ ┌┐ ┌───────┐ ┌┐ ┌───┐ ││
││·│   │·││ └──┐ ┌──┘ ││·│   │·││
││ └───┘ ││ · ·│ │· · ││ └───┘ ││
││· · · ·│└──┐ │ │ ┌──┘│· · · ·││
┘└─────┐ └───┘ └─┘ └───┘ ┌─────┘└
───────┘· · · · · · · · ·└───────
         ┌─┐ ╔══≡══╗ ┌─┐         
───────┐·│ │·║     ║·│ │·┌───────
┐┌─────┘ └─┘ ║     ║ └─┘ └─────┐┌
││· · · · · ·╚═════╝· · · · · ·││
││ ┌───┐ ┌─┐         ┌─┐ ┌───┐ ││
││·│   │·│ │·┌─────┐·│ │·│   │·││
││ └───┘ │ │ └─────┘ │ │ └───┘ ││
││■ · · ·│ │· · · · ·│ │· · · ■││
│└───────┘ └─────────┘ └───────┘│
└───────────────────────────────┘
┌──────────────┐ ┌──────────────┐
│┌───────────┐ │ │ ┌───────────┐│
││■ · · · · ·│ │ │ │· · · · · ■││
││ ┌──┐ ┌──┐ │ │ │ │ ┌──┐ ┌──┐ ││
││·│  │·│  │·│ │ │ │·│  │·│  │·││
││ └──┘ └──┘ └─┘ └─┘ └──┘ └──┘ ││
││· · · · · · · · · · · · · · ·││
│└────┐ ┌────┐ ┌─┐ ┌────┐ ┌────┘│
│┌────┘ └────┘ │ │ └────┘ └────┐│
││· · · · · · ·│ │· · · · · · ·││
││ ┌─┐ ┌───┐ ┌─┘ └─┐ ┌───┐ ┌─┐ ││
││·│ │·└──┐│·└─────┘·│┌──┘·│ │·││
││ │ │   ·││  · · ·  ││·   │ │ ││
││·│ │·┌┐ └┘·╔══≡══╗·└┘ ┌┐·│ │·││
││ └─┘ ││·   ║     ║   ·││ └─┘ ││
││· · ·│└──┐·║     ║·┌──┘│· · ·││
││ ┌─┐ └───┘ ╚═════╝ └───┘ ┌─┐ ││
││·│ │· · · ·       · · · ·│ │·││
││ │ └──┐ ┌┐ ┌─────┐ ┌┐ ┌──┘ │ ││
││·└────┘ ││·└─────┘·││ └────┘·││
││  ■ · · ││  · · ·  ││ · · ■  ││
│└────────┘└───┐ ┌───┘└────────┘│
└──────────────┘ └──────────────┘
┌───────────────────────────────┐
│┌─────┐ ┌─────┐ ┌─────┐ ┌─────┐│
││■ · ·│ │· · ·│ │· · ·│ │· · ■││
││ ┌─┐ │ │ ┌─┐ │ │ ┌─┐ │ │ ┌─┐ ││
││·│ │·└─┘·│ │·│ │·│ │·└─┘·│ │·││
││ │ │ · · │ │ │ │ │ │ · · │ │ ││
││·│ └─┐ ┌─┘ │·│ │·│ └─┐ ┌─┘ │·││
││ │   │·│   │ │ │ │   │·│   │ ││
││·└───┘ └───┘·│ │·└───┘ └───┘·││
││ · · · · · · │ │ · · · · · · ││
│└───┐ ┌───────┘ └───────┐ ┌───┘│
│┌───┘ │  ┌───────────┐  │ └───┐│
││· · ·│  │           │  │· · ·││
││ ┌─┐ │  │·╔═══≡═══╗·│  │ ┌─┐ ││
││·│ │·└──┘ ║       ║ └──┘·│ │·││
││ │ │ · · ·║       ║· · · │ │ ││
││·└─┘·┌──┐ ╚═══════╝ ┌──┐·└─┘·││
││ · · │  │· · ┌─┐ · ·│  │ · · ││
││·┌───┘  └──┐·│ │·┌──┘  └───┐·││
││ └─────────┘ │ │ └─────────┘ ││
││■ · · · · · ·│ │· · · · · · ■││
│└─────────────┘ └─────────────┘│
└───────────────────────────────┘
┌───────────────────────────────┐
│┌────┐ ┌───────────────┐ ┌────┐│
││ ■ ·│ │· · · · · · · ·│ │· ■ ││
││·┌┐ │ │ ┌────┐ ┌────┐ │ │ ┌┐·││
││ ││·│ │·└────┘ └────┘·│ │·││ ││
││·││ │ │ · · · · · · · │ │ ││·││
││ ││·│ │·┌────┐ ┌────┐·│ │·││ ││
││·└┘ └─┘ │┌───┘ └───┐│ └─┘ └┘·││
││ · · · ·││ · · · · ││· · · · ││
│└──┐ ┌─┐ └┘·┌─────┐·└┘ ┌─┐ ┌──┘│
└───┘·│ │· · │     │ · ·│ │·└───┘
      │ │ ┌┐·└─────┘·┌┐ │ │      
┌───┐·│ │·││ · · · · ││·│ │·┌───┐
│┌──┘ └─┘ ││·╔══≡══╗·││ └─┘ └──┐│
││ · · · ·││ ║     ║ ││· · · · ││
││·┌────┐ ││·║     ║·││ ┌────┐·││
││ │    │·││ ╚═════╝ ││·│    │ ││
││·│    │ └┘·       ·└┘ │    │·││
││ │    │· · ┌─────┐ · ·│    │ ││
││·└────┘ ┌┐·└─────┘·┌┐ └────┘·││
││ ■ · · ·││ · · · · ││· · · ■ ││
│└────────┘└─────────┘└────────┘│
└───────────────────────────────┘
┌───────────────────────────────┐
│    ┌─────────────────────┐    │
│   ┌┘ · · · · · · · · · ■ └┐   │
│   │ ·┌─┐ ┌───┐ ┌───┐ ┌─┐· │   │
│ ┌─┘·┌┘┌┘ └───┘ └───┘ └┐└┐·└─┐ │
│ │ · │ │ · · · · · · · │ │ · │ │
│┌┘·┌─┘ │·┌┐ ┌─────┐ ┌┐·│ └─┐·└┐│
││· │┌──┘ ││·│     │·││ └──┐│ ·││
││ ┌┘│ · ·││ └─────┘ ││· · │└┐ ││
││·│ │·┌┐ ││· · · · ·││ ┌┐·│ │·││
││ └─┘ ││·│└─────────┘│·││ └─┘ ││
││· · ·││ │┌─────────┐│ ││· · ·││
││ ┌─┐ ││·││ · · · · ││·││ ┌─┐ ││
││·│ │·└┘ ││·╔══≡══╗·││ └┘·│ │·││
││ └┐│ · ·││ ║     ║ ││· · │┌┘ ││
││· │└──┐ ││·║     ║·││ ┌──┘│ ·││
│└┐·└─┐ │·└┘ ╚═════╝ └┘·│ ┌─┘·┌┘│
│ │ · │ │ · ·       · · │ │ · │ │
│ └─┐·└┐└─┐ ┌──┐ ┌──┐ ┌─┘┌┘·┌─┘ │
│   │ ■└──┘ └──┘ └──┘ └──┘· │   │
│   └┐ · · · · · · · · · · ┌┘   │
│    └─────────────────────┘    │
└───────────────────────────────┘
┌──────────────┐ ┌──────────────┐
│┌────────────┐│ │┌────────────┐│
││· · · · · · ││ ││ · · · · · ·││
││ ┌───┐ ╔══╗·└┘ └┘·╔══╗ ┌───┐ ││
││·│   │·║  ║ · · · ║  ║·│   │·││
││ │   │ ║  ╚═══════╝  ║ │   │ ││
││·└───┘·║             ║·└───┘·││
││ · · · ╚═════════════╝ · · · ││
│└─┐ ╔═╗· · · · ■ · · · ·╔═╗ ┌─┘│
│  │ ║ ║ ┌─────┐ ┌─────┐ ║ ║ │  │
└──┘·║ ║·│     │·│     │·║ ║·└──┘
     ║ ║ │ ┌───┘ └───┐ │ ║ ║     
┌──┐·║ ║·│ │· · · · ·│ │·║ ║·┌──┐
│  │ ║ ║ └─┘ ╔══≡══╗ └─┘ ║ ║ │  │
│┌─┘·╚═╝·   ·║     ║·   ·╚═╝·└─┐│
││ · · · ┌─┐ ║     ║ ┌─┐ · · · ││
││·╔═══╗·│ │·╚═════╝·│ │·╔═══╗·││
││ ║   ║ │ │         │ │ ║   ║ ││
││·║   ║·│ │·┌─┐ ┌─┐·│ │·║   ║·││
││ ╚═══╝ └─┘ └┐│ │┌┘ └─┘ ╚═══╝ ││
││■ · · · · · ││ ││ · · · · · ■││
│└────────────┘│ │└────────────┘│
└──────────────┘ └──────────────┘
