1 33x31 \
    RTOP=12.5             \
  RGHOST=15.5 CGHOST=16.5 \
 ROGHOST=2   COGHOST=2.5 \
  RFRUIT=17.5 CFRUIT=16.5 \
   RHERO=23.5  CHERO=16.5 \
    RMSG=17     CMSG=11   \
   RMSG2=11    CMSG2=11   \
 PLAYER1=" PLAYER ONE"    \
 PLAYER2=" PLAYER TWO"    \
   READY="   READY!  "    \
GAMEOVER=" GAME OVER."    \
   ABOUT="Inspired by the 'Classic Arcade Pac-Man' hand-held game (smaller)"
╔═══════════════╦═══════════════╗
║· · · · · · · ·║· · · · · · · ·║
║ ┌───┐ ┌─────┐ ║ ┌─────┐ ┌───┐ ║
║■│   │·│     │·║·│     │·│   │■║
║ └───┘ └─────┘ ╨ └─────┘ └───┘ ║
║· · · · · · · · · · · · · · · ·║
║ ╞═══╡ ┌─┐ ╞═══╦═══╡ ┌─┐ ╞═══╡ ║
║· · · ·│ │· · ·║· · ·│ │· · · ·║
╚═════╗ │ └───┐ ║ ┌───┘ │ ╔═════╝
      ║·│     │ ║ │     │·║      
      ║ │ ┌───┘ ╨ └───┐ │ ║      
      ║·│ │           │ │·║      
══════╝ └─┘ ╔═══≡═══╗ └─┘ ╚══════
 · · · ·    ║       ║    · · · · 
══════╗ ┌─┐ ║       ║ ┌─┐ ╔══════
      ║·│ │ ║       ║ │ │·║      
      ║ │ │ ╚═══════╝ │ │ ║      
      ║·│ │           │ │·║      
╔═════╝ └─┘ ╞═══╦═══╡ └─┘ ╚═════╗
║· · · · · · · ·║· · · · · · · ·║
║ ┌───┐ ┌─────┐ ║ ┌─────┐ ┌───┐ ║
║·│   │·│     │·║·│     │·│   │·║
║ └─┐ │ └─────┘ ╨ └─────┘ │ ┌─┘ ║
║■ ·│ │· · · · · · · · · ·│ │· ■║
╠═╡ └─┘ ┌─┐ ╞═══╦═══╡ ┌─┐ └─┘ ╞═╣
║· · · ·│ │· · ·║· · ·│ │· · · ·║
║ ┌─────┘ └───┐ ║ ┌───┘ └─────┐ ║
║·│           │·║·│           │·║
║ └───────────┘ ╨ └───────────┘ ║
║· · · · · · · · · · · · · · · ·║
╚═══════════════════════════════╝
