1 35x37 \
    RTOP=16.5             \
  RGHOST=19   CGHOST=17.5 \
 ROGHOST=2    COGHOST=2.5 \
  RFRUIT=21.5 CFRUIT=17.5 \
   RHERO=27.5  CHERO=17.5 \
    RMSG=21     CMSG=12   \
   RMSG2=15    CMSG2=12   \
 PLAYER1=" PLAYER ONE"    \
 PLAYER2=" PLAYER TWO"    \
   READY="   READY!  "    \
GAMEOVER=" GAME OVER."    \
   ABOUT="Inspired by the 'Classic Arcade Pac-Man' hand-held game"
╔═══════════════╕─╒═══════════════╗
║· · · · · · · ·│ │· · · · · · · ·║
║ ┌───┐ ┌─────┐ │ │ ┌─────┐ ┌───┐ ║
║■│   │·│     │·│ │·│     │·│   │■║
║ │   │ │     │ │ │ │     │ │   │ ║
║·│   │·│     │·│ │·│     │·│   │·║
║ └───┘ └─────┘ └─┘ └─────┘ └───┘ ║
║· · · · · · · · · · · · · · · · ·║
║ ┌───┐ ┌─┐ ┌─────────┐ ┌─┐ ┌───┐ ║
║·│   │·│ │·│         │·│ │·│   │·║
║ └───┘ │ │ └───┐ ┌───┘ │ │ └───┘ ║
║· · · ·│ │· · ·│ │· · ·│ │· · · ·║
╚═════╗ │ └───┐ │ │ ┌───┘ │ ╔═════╝
      ║·│     │ │ │ │     │·║      
      ║ │ ┌───┘ └─┘ └───┐ │ ║      
      ║·│ │             │ │·║      
══════╝ └─┘ ╔════≡════╗ └─┘ ╚══════
 · · · ·    ║         ║    · · · · 
══════╗ ┌─┐ ║         ║ ┌─┐ ╔══════
      ║·│ │ ║         ║ │ │·║      
      ║ │ │ ╚═════════╝ │ │ ║      
      ║·│ │             │ │·║      
╔═════╝ └─┘ ╞═══╕─╒═══╡ └─┘ ╚═════╗
║· · · · · · · ·│ │· · · · · · · ·║
║ ┌───┐ ┌─────┐ │ │ ┌─────┐ ┌───┐ ║
║·│   │·│     │·│ │·│     │·│   │·║
║ └─┐ │ └─────┘ └─┘ └─────┘ │ ┌─┘ ║
║■ ·│ │· · · · · · · · · · ·│ │· ■║
╙─┐ │ │ ┌─┐ ┌─────────┐ ┌─┐ │ │ ┌─╜
│ │·│ │·│ │·│         │·│ │·│ │·│ │
╓─┘ └─┘ │ │ └───┐ ┌───┘ │ │ └─┘ └─╖
║· · · ·│ │· · ·│ │· · ·│ │· · · ·║
║ ┌─────┘ └───┐ │ │ ┌───┘ └─────┐ ║
║·│           │·│ │·│           │·║
║ └───────────┘ └─┘ └───────────┘ ║
║· · · · · · · · · · · · · · · · ·║
╚═════════════════════════════════╝
