1 19x23 READY=" READY!" GAMEOVER="GOODBYE" PLAYER1=" P ONE " PLAYER2=" P TWO " RGHOST=11.5 ROGHOST=1 COGHOST=0.5 RFRUIT=13.5 RHERO=17.5 RMSG=13 CMSG=6 RMSG2=8 CMSG2=6 ABOUT="Inspired by the 'Pac-Man' game by Ebivision"
╔════════╦════════╗
║········║········║
║■┌─┐·┌┐·║·┌┐·┌─┐■║
║·└─┘·└┘·╨·└┘·└─┘·║
║········ ········║
║·┌─┐·╥·╞╦╡·╥·┌─┐·║
║·└─┘·║··║··║·└─┘·║
║·····╠╡ ╨ ╞╣·····║
╚═══╗·║     ║·╔═══╝
    ║·║ ╔≡╗ ║·║    
════╝·╨ ║ ║ ╨·╚════
     ·  ║ ║  ·     
════╗·╥ ╚═╝ ╥·╔════
    ║·║     ║·║    
╔═══╝·╨ ╞╦╡ ╨·╚═══╗
║········║········║
║■╞═╗·╞╡·╨·╞╡·╔═╡■║
║···║···· ····║···║
╠═╡·╨·╥·╞╦╡·╥·╨·╞═╣
║·····║··║··║·····║
║·╞═══╩╡·╨·╞╩═══╡·║
║········ ········║
╚═════════════════╝
