1 38x25 RGHOST=12.5 ROGHOST=1 CGHOST=19.5 RFRUIT=12.5 RTOP=9.5 RHERO=12.5 CHERO=23.5 RMSG=16 CMSG=12 RMSG2=8 CMSG2=12 NOTE="The original maze has quad-dots which are not accurately representable in MyMan's maze format." ABOUT="Inspired by Infogrames's 'Ghostman' game for the Oric"
╔═══════════════╡  ╞═════════════════╗
║··■·························■·······║
║····································║
║··┌┐··╥··┌─────┐··┌─────┐··┌──┐··╥··║
║··└┘··╨··└─────┘··└─────┘··└──┘··║··║
║·································║··║
║·································║··║
║··┌┐··╞══╦═════╡  ╞═════╡··╥··╞══╣··║
║··││·····║               ··║·····║··║
║··└┘·····╨               ··╨·····╨··║
║······╥     ╔≡≡═≡≡═≡≡╗  ╥·····╥·····║
║······║     ║        ║  ║·····║·····║
╠═══╡··╠══╡  ║        ║  ╠══╡··╠══╡··║
║······║     ║        ║  ║·····║·····║
║······╨     ╚════════╝  ╨·····╨·····║
║··┌┐·····╥               ··╥·····╥··║
║··││·····║               ··║·····║··║
║··└┘··╞══╩═════╡  ╞═════╡··╨··╞══╣··║
║·································║··║
║·································║··║
║··┌┐··╥··┌─────┐··┌─────┐··┌──┐··║··║
║··└┘··╨··└─────┘··└─────┘··└──┘··╨··║
║··■·························■·······║
║····································║
╚═══════════════╡  ╞═════════════════╝
