1 29x24 RHERO=18.5 RFRUIT=14.5 RGHOST=12 ROGHOST=1.5 COGHOST=2 RTOP=9.5 RMSG=14 CMSG=10 RMSG2=8 CMSG2=10 READY=" READY!! " PLAYER1=" PLAYER 1" PLAYER2=" PLAYER 2" GAMEOVER="GAME OVER" ABOUT="Inspired by CDS Microsystems's 'Gobble A Ghost'"
 ╔════════════╦════════════╗ 
 ║············║············║ 
 ║■┌──┐·┌───┐·║·┌───┐·┌──┐■║ 
 ║·└──┘·└───┘·╨·└───┘·└──┘·║ 
 ║·························║ 
 ║·╞══╡·╥·╞═══╦═══╡·╥·╞══╡·║ 
 ║······║·····║·····║······║ 
 ╚════╗·╠═══╡ ╨ ╞═══╣·╔════╝ 
      ║·║           ║·║      
      ║·║ ╔═══≡═══╗ ║·║      
══════╝·╨ ║       ║ ╨·╚══════
       ·  ║       ║  ·       
══════╗·╥ ║       ║ ╥·╔══════
      ║·║ ╚═══════╝ ║·║      
      ║·║           ║·║      
 ╔════╝·╨ ╞═══╦═══╡ ╨·╚════╗ 
 ║············║············║ 
 ║■╞══╗·╞═══╡·╨·╞═══╡·╔══╡■║ 
 ║····║······· ·······║····║ 
 ╠══╡·╨·╥·╞═══╦═══╡·╥·╨·╞══╣ 
 ║······║·····║·····║······║ 
 ║·╞════╩═══╡·╨·╞═══╩════╡·║ 
 ║·························║ 
 ╚═════════════════════════╝ 
