13 25x23~1 READY=" READY!" PLAYER1=" P ONE " PLAYER2=" P TWO " GAMEOVER="GOODBYE" RMSG2=9 CMSG2=9 RMSG=13 CMSG=9 RTOP=10.5 RGHOST=11.5 ROGHOST=2 COGHOST=1 RFRUIT=13.5 RHERO=17.5,17.5,17.5,17.5,17.5,17.5,19.5,19.5,17.5,15.5,17.5,19.5,17.5 WALL_COLORS="\x08\x09\x0C\x06\x0E\x02\x08\x00\x04\x0B\x04\x04\x08" MORTAR_COLORS="\x0E\x0C\x0F\x0E\x09\x0A\x09\x0F\x0C\x0F\x07\x0F\x07" DOT_COLORS="\x03\x0F\x02\x07\x0F\x0A\x0E\x06\x0F\x0B\x06\x0F\x0C" PELLET_COLORS="\x0F" ABOUT="Inspired by Lafe Travis Fredbjornson/Lafe Travis Games's 'Grandpa Pac-Man' (maze slightly reduced)"
  ╔═══════╗   ╔═══════╗  
  ║· · · ·║   ║· · · ·║  
╔═╝ ╥ ╞═╗ ╚═══╝ ╔═╡ ╥ ╚═╗
║· ■║· ·║· · · ·║· ·║■ ·║
║ ╞═╩═╡ ╨ ╞═══╡ ╨ ╞═╩═╡ ║
║· · · · · · · · · · · ·║
╠═╡ ╥ • ╞═╡ ╥ ╞═╡ • ╥ ╞═╣
║  ·║· · · ·║· · · ·║·  ║
╝ ╥ ╨ • ╔═╡ ╨ ╞═╗ • ╨ ╥ ╚
  ║· · ·║       ║· · ·║  
══╣ ╥ ╞═╝ ╔═≡═╗ ╚═╡ ╥ ╠══
  ║·║· ·  ║   ║  · ·║·║  
╔═╝ ╨ ╞═╗ ╚═══╝ ╔═╡ ╨ ╚═╗
║· · · ·║       ║· · · ·║
╝ ╥ • ╥ ╨ ╞═╦═╡ ╨ ╥ • ╥ ╚
 ·║· ·║· · ·║· · ·║· ·║· 
╗ ╨ • ║ ╥ ╥ ╨ ╥ ╥ ║ • ╨ ╔
║· · ·║·║·║· ·║·║·║· · ·║
║ ╞═╗ ╨ ╨ ╨ ╥ ╨ ╨ ╨ ╔═╡ ║
║· ■║· · · ·║· · · ·║■ ·║
╚═╗ ╨ ╞═╡ ╔═╩═╗ ╞═╡ ╨ ╔═╝
  ║· · · ·║   ║· · · ·║  
  ╚═══════╝   ╚═══════╝  
╔═══════════════════════╗
║■ · · · · · · · · · · ■║
║ ╔═══╡ ╔═╡ ╥ ╞═╗ ╞═══╗ ║
║·║· · ·║· ·║· ·║· · ·║·║
║ ╨ ╥ ╔═╝ ╥ ╨ ╥ ╚═╗ ╥ ╨ ║
║· ·║·║· ·║· ·║· ·║·║· ·║
╩═╡ ╨ ╨ • ╨ ╥ ╨ • ╨ ╨ ╞═╩
   · · · · ·║· · · · ·   
╦═╡ ╞═╡ ╔═╡ ╨ ╞═╗ ╞═╡ ╞═╦
║· · · ·║       ║· · · ·║
║ ╔═╡ ╞═╝ ╔═≡═╗ ╚═╡ ╞═╗ ║
║·║· · ·  ║   ║  · · ·║·║
║ ╨ ╥ ╞═╡ ╚═══╝ ╞═╡ ╥ ╨ ║
║· ·║· ·         · ·║· ·║
║ ╞═╣ ╥ ╞═╡ ╥ ╞═╡ ╥ ╠═╡ ║
║· ·║·║· · ·║· · ·║·║· ·║
║ ╥ ╨ ╨ ╞═╡ ╨ ╞═╡ ╨ ╨ ╥ ║
║·║· · · · · · · · · ·║·║
║ ╚═╗ ╞═╗ ╔═══╗ ╔═╡ ╔═╝ ║
║· ■║· ·║·║· ·║·║· ·║■ ·║
╚═╗ ╚═╡ ╨ ╨ ╥ ╨ ╨ ╞═╝ ╔═╝
  ║· · · · ·║· · · · ·║  
  ╚═════════╩═════════╝  
╔═══╝ ╚═══╗   ╔═══╝ ╚═══╗
║· · · · ·║   ║· · · · ·║
║ ╞═╗ ╔═╡ ╚═╦═╝ ╞═╗ ╔═╡ ║
║· ·║·║· · ·║· · ·║·║· ·║
║ ╥ ╨ ╨ ╔═╡ ╨ ╞═╗ ╨ ╨ ╥ ║
║·║· ■ ·║· · · ·║· ■ ·║·║
║ ╚═╡ ╥ ╨ ╞═══╡ ╨ ╥ ╞═╝ ║
║· · ·║· · · · · ·║· · ·║
╚═╗ ╥ ╚═══╡ • ╞═══╝ ╥ ╔═╝
  ║·║· ·         · ·║·║  
╔═╝ ╨ ┌─┐ ╔═≡═╗ ┌─┐ ╨ ╚═╗
║· · ·│ │ ║   ║ │ │· · ·║
║ ┌─┐ └─┘ ╚═══╝ └─┘ ┌─┐ ║
║·│ │· ·         · ·│ │·║
║ └─┘ ┌─┐ ╥ • ╥ ┌─┐ └─┘ ║
║· · ·│ │·║· ·║·│ │· · ·║
║ ╔═╡ └─┘ ╨ • ╨ └─┘ ╞═╗ ║
║■║· · · · · · · · · ·║■║
║ ╨ ╔═╡ ╔═╡ ╥ ╞═╗ ╞═╗ ╨ ║
║· ·║· ·║· ·║· ·║· ·║· ·║
║ ╞═╝ ╞═╝ ╔═╩═╗ ╚═╡ ╚═╡ ║
║· · · · ·║   ║· · · · ·║
╚═══╗ ╔═══╝   ╚═══╗ ╔═══╝
╔═════════╦═══╦═════════╗
║■ · · · ·║· ·║· · · · ■║
║ ╔═╡ ╞═╗ ╨ ╥ ╨ ╔═╡ ╞═╗ ║
║·║· · ·║· ·║· ·║· · ·║·║
╝ ╨ ╔═╡ ╨ ╞═╩═╡ ╨ ╞═╗ ╨ ╚
 · ·║· · · · · · · ·║· · 
╗ ╥ ╨ ╔═╡ ╞═╦═╡ ╞═╗ ╨ ╥ ╔
║·║· ·║· · ·║· · ·║· ·║·║
║ ╚═╡ ╨ ╔═╡ ╨ ╞═╗ ╨ ╞═╝ ║
║· · · ·║       ║· · · ·║
╚═╗ ╞═╡ ╨ ╔═≡═╗ ╨ ╞═╡ ╔═╝
  ║· · ·  ║   ║  · · ·║  
╔═╝ ╞═╡ ╥ ╚═══╝ ╥ ╞═╡ ╚═╗
║· · · ·║       ║· · · ·║
║ ╔═╡ ╥ ╚═╡ ╥ ╞═╝ ╥ ╞═╗ ║
║·║· ·║· · ·║· · ·║· ·║·║
╝ ╨ ╥ ╚═╗ ╞═╩═╡ ╔═╝ ╥ ╨ ╚
 · ·║· ·║· · · ·║· ·║· · 
╗ ╥ ╚═╡ ╨ ╞═╦═╡ ╨ ╞═╝ ╥ ╔
║·║· · · · ·║· · · · ·║·║
║ ╚═╡ ╞═══╡ ╨ ╞═══╡ ╞═╝ ║
║■ · · · · · · · · · · ■║
╚═══════════════════════╝
══════╦═════╦═════╦══════
      ║· ■ ·║· ■ ·║      
╒═══╡ ╨ ┌─┐ ╨ ┌─┐ ╨ ╞═══╕
│· · · ·│ │· ·│ │· · · ·│
│ ╥ ┌─┐ └─┘ ╥ └─┘ ┌─┐ ╥ │
│·║·│ │· · ·║· · ·│ │·║·│
│ ╨ └─┘ ╥ ╔═╩═╗ ╥ └─┘ ╨ │
│· · · ·║·║· ·║·║· · · ·│
│ ╥ ╞═══╣ ╨ • ╨ ╠═══╡ ╥ │
│·║· · ·║       ║· · ·║·│
│ ╚═╡ ╥ ╨ ╔═≡═╗ ╨ ╥ ╞═╝ │
│■ · ·║·  ║   ║  ·║· · ■│
│ ╔═╡ ╚═╡ ╚═══╝ ╞═╝ ╞═╗ │
│·║· · ·         · · ·║·│
│ ╨ ╞═══╡ ╥ • ╥ ╞═══╡ ╨ │
│· · · · ·║· ·║· · · · ·│
╞═╡ ┌─┐ • ╚═══╝ • ┌─┐ ╞═╡
│· ·│ │· · · · · ·│ │· ·│
│ ╥ └─┘ ┌─┐ • ┌─┐ └─┘ ╥ │
│·║· · ·│ │· ·│ │· · ·║·│
┘ ╚═╡ ╥ └─┘ ╥ └─┘ ╥ ╞═╝ └
 · · ·║· ■ ·║· ■ ·║· · · 
══════╩═════╩═════╩══════
╔═══════════╦═══════════╗
║· · · · · v║v · · · · ·║
║ ┌─┐ ╔═╡ ╞═╩═╡ ╞═╗ ┌─┐ ║
║■│ │·║· · · · · ·║·│ │■║
║ └─┘ ╨ ┌─┐ ╥ ┌─┐ ╨ └─┘ ║
║· · · ·│ │·║·│ │· · · ·║
║ ╥ ╞═╗ └─┘ ╨ └─┘ ╔═╡ ╥ ║
║·║· ·║· · · · · ·║· ·║·║
║ ╚═╡ ╨ ╞═╡ • ╞═╡ ╨ ╞═╝ ║
║· · · ·         · · · ·║
║ ╥ ┌─┐ ╥ ╔═≡═╗ ╥ ┌─┐ ╥ ║
║·║·│ │·║ ║   ║ ║·│ │·║·║
║ ╨ └─┘ ╨ ╚═══╝ ╨ └─┘ ╨ ║
║· · · ·         · · · ·║
║ ┌─┐ ╔═╡ ╞═══╡ ╞═╗ ┌─┐ ║
║·│ │·║· · · · · ·║·│ │·║
║ └─┘ ╨ ╔═╡ • ╞═╗ ╨ └─┘ ║
║· · · ·║· · · ·║· · · ·║
║ ╥ ┌─┐ ╨ ╔═╦═╗ ╨ ┌─┐ ╥ ║
║·║■│ │· ·║^║^║· ·│ │■║·║
║ ╨ └─┘ ╞═╝ ║ ╚═╡ └─┘ ╨ ║
║· · · · · ·║· · · · · ·║
╚═══════════╩═══════════╝
║ ╙─╒═════╕───╒═════╕─╜ ║
║ │ │· ■ ·│   │· ■ ·│ │ ║
║ └─┘ ┌─┐ └───┘ ┌─┐ └─┘ ║
║· · ·│ │· · · ·│ │· · ·║
║ ┌─┐ └─┘ ╞═╦═╡ └─┘ ┌─┐ ║
║·│ │· · · ·║· · · ·│ │·║
║ └─┘ ╥ ╞═╡ ║ ╞═╡ ╥ └─┘ ║
║· · ·║· · ·║· · ·║· · ·║
╙─┐ ╔═╝ • ╞═╩═╡ • ╚═╗ ┌─╜
│ │·║· ·         · ·║·│ │
╓─┘ ╨ ┌─┐ ╔═≡═╗ ┌─┐ ╨ └─╖
║· · ·│ │ ║   ║ │ │· · ·║
║ ╞═╗ └─┘ ╚═══╝ └─┘ ╔═╡ ║
║· ·║· ·         · ·║· ·║
╙─┐ ╚═╗ • ╞═╦═╡ • ╔═╝ ┌─╜
│ │· ·║· · ·║· · ·║· ·│ │
╓─┘ ╥ ╨ ╞═╡ ║ ╞═╡ ╨ ╥ └─╖
║· ·║· · · ·║· · · ·║· ·║
║ ╞═╝ ┌─┐ ╞═╩═╡ ┌─┐ ╚═╡ ║
║· · ·│ │· · · ·│ │· · ·║
║ ┌─┐ └─┘ ┌───┐ └─┘ ┌─┐ ║
║ │ │· ■ ·│   │· ■ ·│ │ ║
║ ╓─╘═════╛───╘═════╛─╖ ║
════════╗ ╔═══╗ ╔════════
 · · · ·║ ║· ·║ ║· · · · 
╦═╡ ╞═╗ ╚═╝ • ╚═╝ ╔═╡ ╞═╦
║· · ·║· · · · · ·║· · ·║
║ ╔═╡ ╨ ╞═╡ ╥ ╞═╡ ╨ ╞═╗ ║
║·║· ■ · · ·║· · · ■ ·║·║
║ ╨ ╥ ╞═╗ ╞═╩═╡ ╔═╡ ╥ ╨ ║
║· ·║· ·║· · · ·║· ·║· ·║
║ ╞═╩═╡ ╨ • • • ╨ ╞═╩═╡ ║
║· · · ·         · · · ·║
╚═╗ ┌─┐ • ╔═≡═╗ • ┌─┐ ╔═╝
  ║·│ │·  ║   ║  ·│ │·║  
╔═╝ └─┘ • ╚═══╝ • └─┘ ╚═╗
║· · · ·         · · · ·║
║ ╞═╗ ╞═╡ • • • ╞═╡ ╔═╡ ║
║· ·║· · · · · · · ·║· ·║
║ ╥ ╚═╡ ╥ ╞═╦═╡ ╥ ╞═╝ ╥ ║
║·║· ■ ·║· ·║· ·║· ■ ·║·║
║ ╚═╡ ╥ ╚═╡ ╨ ╞═╝ ╥ ╞═╝ ║
║· · ·║· · · · · ·║· · ·║
╩═╡ ╞═╝ ╔═╗ • ╔═╗ ╚═╡ ╞═╩
 · · · ·║ ║· ·║ ║· · · · 
════════╝ ╚═══╝ ╚════════
  ╔═════╗ ╔═══╗ ╔═════╗  
  ║· · ·║ ║· ·║ ║· · ·║  
══╝ ╥ ╥ ╚═╝ ╥ ╚═╝ ╥ ╥ ╚══
   ·║■║· · ·║· · ·║■║·   
╒═╡ ╨ ╨ ╞═══╬═══╡ ╨ ╨ ╞═╕
│· · · · · ·║· · · · · ·│
│ • ╥ ┌─┐ ╥ ║ ╥ ┌─┐ ╥ • │
│· ·║·│ │·║·║·║·│ │·║· ·│
╞═╡ ║ └─┘ ╨ ╨ ╨ └─┘ ║ ╞═╡
│· ·║· ·         · ·║· ·│
│ ╥ ╨ ╞═╗ ╔═≡═╗ ╔═╡ ╨ ╥ │
│·║· · ·║ ║   ║ ║· · ·║·│
│ ╨ ╞═╗ ║ ╚═══╝ ║ ╔═╡ ╨ │
│· · ·║·║       ║·║· · ·│
│ ╞═╡ ╨ ╚═╡ ╥ ╞═╝ ╨ ╞═╡ │
│· · · · · ·║· · · · · ·│
╘═╡ ╥ ╥ ┌─┐ ╨ ┌─┐ ╥ ╥ ╞═╛
   ·║■║·│ │· ·│ │·║■║·   
╦═╡ ╨ ╨ └─┘ • └─┘ ╨ ╨ ╞═╦
║· · · · · · · · · · · ·║
║ ╞═╡ ╥ ╞═╡ ╥ ╞═╡ ╥ ╞═╡ ║
║· · ·║· · ·║· · ·║· · ·║
╚═════╩═════╩═════╩═════╝
  ╔═════════╦═════════╗  
  ║· · · · ·║· · · · ·║  
══╝ ╞═╡ ╔═╡ ╨ ╞═╗ ╞═╡ ╚══
   · · ·║· · · ·║· · ·   
══╗ ╥ ╥ ╨ ╞═╦═╡ ╨ ╥ ╥ ╔══
  ║·║■║· · ·║· · ·║■║·║  
╔═╝ ╨ ╚═╗ ╥ ╨ ╥ ╔═╝ ╨ ╚═╗
║· · · ·║·║· ·║·║· · · ·║
║ ╞═╡ ╥ ╨ ╚═══╝ ╨ ╥ ╞═╡ ║
║· · ·║·         ·║· · ·║
║ ╞═╡ ╨ ╥ ╔═≡═╗ ╥ ╨ ╞═╡ ║
║· · · ·║ ║   ║ ║· · · ·║
║ ╥ ╥ ╔═╝ ╚═══╝ ╚═╗ ╥ ╥ ║
║·║·║·║·         ·║·║·║·║
║ ╨ ╨ ╨ ┌─┐ • ┌─┐ ╨ ╨ ╨ ║
║· · · ·│ │· ·│ │· · · ·║
╚═╗ ╥ ╥ └─┘ ╥ └─┘ ╥ ╥ ╔═╝
  ║·║·║· · ·║· · ·║·║·║  
══╝ ╨ ╚═╗ ╞═╬═╡ ╔═╝ ╨ ╚══
   · · ·║· ·║· ·║· · ·   
══╗ ╞═╡ ╨ ╥ ╨ ╥ ╨ ╞═╡ ╔══
  ║· ■ · ·║· ·║· · ■ ·║  
  ╚═══════╩═══╩═══════╝  
╔═════╗ ╔══╝ ╚══╗ ╔═════╗
║■ · ·║ ║· · · ·║ ║· · ■║
║ ┌─┐ ╚═╝ ╞═══╡ ╚═╝ ┌─┐ ║
║·│ │· · · · · · · ·│ │·║
║ └─┘ ╔═╡ ╞═══╡ ╞═╗ └─┘ ║
║· · ·║· · · · · ·║· · ·║
║ ╔═╡ ╨ ╥ ╞═╦═╡ ╥ ╨ ╞═╗ ║
║·║· · ·║· ·║· ·║· · ·║·║
║ ╨ ╥ ╥ ╠═╡ ╨ ╞═╣ ╥ ╥ ╨ ║
║· ·║·║·║       ║·║·║· ·║
║ ╞═╝ ╨ ╨ ╔═≡═╗ ╨ ╨ ╚═╡ ║
║· · · ·  ║   ║  · · · ·║
╚═╗ ╞═╡ ╥ ╚═══╝ ╥ ╞═╡ ╔═╝
  ║· · ·║       ║· · ·║  
╔═╝ ┌─┐ ╨ ╞═╦═╡ ╨ ┌─┐ ╚═╗
║· ·│ │· · ·║· · ·│ │· ·║
║ ╥ └─┘ ┌─┐ ╨ ┌─┐ └─┘ ╥ ║
║■║· · ·│ │· ·│ │· · ·║■║
║ ╨ ╔═╡ └─┘ ╥ └─┘ ╞═╗ ╨ ║
║· ·║· · · ·║· · · ·║· ·║
╚═╗ ╨ ╔═╗ ╞═╩═╡ ╔═╗ ╨ ╔═╝
  ║· ·║ ║· · · ·║ ║· ·║  
  ╚═══╝ ╚══╗ ╔══╝ ╚═══╝  
  ╔═══════════════════╗  
  ║· · · · · · · · · ·║  
╔═╝ ╞═╦═╡ ╔═══╗ ╞═╦═╡ ╚═╗
║· · ·║· ·║· ·║· ·║· · ·║
║ ┌─┐ ╨ ╥ ╨ ╥ ╨ ╥ ╨ ┌─┐ ║
║■│ │· ·║· ·║· ·║· ·│ │■║
║ └─┘ ╥ ╨ ╞═╬═╡ ╨ ╥ └─┘ ║
║· · ·║· · ·║· · ·║· · ·║
╠═╡ ╔═╝ ╔═╡ ╨ ╞═╗ ╚═╗ ╞═╣
║· ·║· ·║       ║· ·║· ·║
╝ ╞═╝ ╞═╝ ╔═≡═╗ ╚═╡ ╚═╡ ╚
 · · · ·  ║   ║  · · · · 
╗ ╞═╗ ╞═╗ ╚═══╝ ╔═╡ ╔═╡ ╔
║· ·║· ·║       ║· ·║· ·║
╠═╡ ╚═╗ ╚═╡ ╥ ╞═╝ ╔═╝ ╞═╣
║· · ·║· · ·║· · ·║· · ·║
║ ╥ ╥ ╨ ╥ ╞═╬═╡ ╥ ╨ ╥ ╥ ║
║·║■║· ·║· ·║· ·║· ·║■║·║
║ ╨ ╚═╡ ╨ ╥ ╨ ╥ ╨ ╞═╝ ╨ ║
║· · · · ·║· ·║· · · · ·║
╚═╗ ╞═══╡ ╚═══╝ ╞═══╡ ╔═╝
  ║· · · · · · · · · ·║  
  ╚═══════════════════╝  
╔═══════╦═══════╦═══════╗
║■ · · ·║· · · ·║· · · ■║
║ ╥ ┌─┐ ╨ ╥ ╥ ╥ ╨ ┌─┐ ╥ ║
║·║·│ │· ·║·║·║· ·│ │·║·║
║ ║ └─┘ ╥ ║ ╨ ║ ╥ └─┘ ║ ║
║·║· · ·║·║· ·║·║· · ·║·║
║ ╚═╡ ╥ ╨ ╨ ╥ ╨ ╨ ╥ ╞═╝ ║
║· · ·║· · ·║· · ·║· · ·║
╚═╗ ╞═╬═╡ ╞═╩═╡ ╞═╬═╡ ╔═╝
  ║· ·║·         ·║· ·║  
══╩═╡ ╨ ╥ ╔═≡═╗ ╥ ╨ ╞═╩══
     · ·║ ║   ║ ║· ·     
══╦═╡ ╥ ╨ ╚═══╝ ╨ ╥ ╞═╦══
  ║· ·║·         ·║· ·║  
╔═╝ ╞═╬═╡ ╞═╦═╡ ╞═╬═╡ ╚═╗
║· · ·║· · ·║· · ·║· · ·║
║ ╞═╡ ╨ ╞═╡ ╨ ╞═╡ ╨ ╞═╡ ║
║· · · · · · · · · · · ·║
║ ┌─┐ ╥ ╥ ╥ ╥ ╥ ╥ ╥ ┌─┐ ║
║·│ │·║·║·║·║·║·║·║·│ │·║
║ └─┘ ║ ╨ ╨ ║ ╨ ╨ ║ └─┘ ║
║■ · ·║· · ·║· · ·║· · ■║
╚═════╩═════╩═════╩═════╝
