3 28x31~2 ABOUT="Inspired by 'Hangly-Man', another early hack of the original Puckman by 'Nittoh'"
╔══════════════════════════╗
║··························║
║·┌──┐·┌───┐·┌┐·┌───┐·┌──┐·║
║■│  │·│   │·││·│   │·│  │■║
╝·└──┘·└───┘·││·└───┘·└──┘·╚
 ············││············ 
╗·┌──┐·┌┐·┌──┘└──┐·┌┐·┌──┐·╔
║·└──┘·││·└──┐┌──┘·││·└──┘·║
║······││····││····││······║
╚═╗   ·│└──┐ ││ ┌──┘│·   ╔═╝
  ║   ·│┌──┘ └┘ └──┐│·   ║  
  ║ ╔╗·││          ││·╔╗ ║  
  ║ ╚╝·└┘ ╔══≡≡══╗ └┘·╚╝ ║  
══╝   ·   ║      ║   ·   ╚══
      ·╔╗ ║      ║ ╔╗·      
══╗   ·╚╝ ║      ║ ╚╝·   ╔══
  ║ ╔╗·   ╚══════╝   ·╔╗ ║  
  ║ ╚╝·┌┐          ┌┐·╚╝ ║  
  ║   ·│└──┐ ┌┐ ┌──┘│·   ║  
╔═╝   ·└───┘ ││ └───┘·   ╚═╗
║············││············║
║·┌──┐·┌───┐·││·┌───┐·┌──┐·║
║·└─┐│·└───┘·└┘·└───┘·│┌─┘·║
║■··││·······  ·······││··■║
╙─┐·││·┌┐·┌──────┐·┌┐·││·┌─╜
──┘·└┘·││·└──┐┌──┘·││·└┘·└──
 ······││····││····││······ 
╗·┌──┐ ││ ┌┐·││·┌┐ ││ ┌──┐·╔
║·└──┘ └┘ └┘·└┘·└┘ └┘ └──┘·║
║··························║
╚══════════════════════════╝
╔══════════════════════════╗
║··························║
║·    ·     ·  ·     ·    ·║
║■    ·     ·  ·     ·    ■║
╝·    ·     ·  ·     ·    ·╚
 ············  ············ 
╗·    ·  ·        ·  ·    ·╔
║·    ·  ·        ·  ·    ·║
║······  ····  ····  ······║
╚═╗   ·              ·   ╔═╝
  ║   ·              ·   ║  
  ║   ·              ·   ║  
  ║   ·   ╔══≡≡══╗   ·   ║  
══╝   ·   ║      ║   ·   ╚══
      ·   ║      ║   ·      
══╗   ·   ║      ║   ·   ╔══
  ║   ·   ╚══════╝   ·   ║  
  ║   ·              ·   ║  
  ║   ·              ·   ║  
╔═╝   ·              ·   ╚═╗
║············  ············║
║·    ·     ·  ·     ·    ·║
║·    ·     ·  ·     ·    ·║
║■··  ·······  ·······  ··■║
╙─┐·  ·  ·        ·  ·  ·┌─╜
──┘·  ·  ·        ·  ·  ·└──
 ······  ····  ····  ······ 
╗·          ·  ·          ·╔
║·          ·  ·          ·║
║··························║
╚══════════════════════════╝
╔═════════════╝ ╚══════════╗
║··························║
║·    ·  ·  ·  ·  ·  ·    ·║
║■    ·  ·  ·  ·  ·  ·    ■║
╝·    ·  ·  ·  ·  ·  ·    ·╚
 ·························· 
╗·    ·  ·        ·  ·    ·╔
║·    ·  ·        ·  ·    ·║
║·    ·  ····  ····  ······║
╚═╗   ·              ·   ╔═╝
  ║   ·              ·   ║  
  ║   ·      ··      ·   ║  
  ║   ·   ╔══≡≡══╗   ·   ║  
══╝   ·  ·║      ║·  ·   ╚══
··    ·   ║      ║   ·      
══╗   ·  ·║      ║·  ·   ╔══
  ║   ·   ╚══════╝   ·   ║  
  ║   ·              ·   ║  
  ║   ·              ·   ║  
╔═╝   ·              ·   ╚═╗
║············  ············║
║·    ·     ·  ·     ·    ·║
║·    ·     ·  ·     ·    ·║
║■···········  ···········■║
╙─┐·  ·  ·        ·  ·  ·┌─╜
──┘·  ·  ·        ·  ·  ·└──
 ············  ············ 
╗·     ╔═══╗·  ·╔═══╗     ·╔
║·     ║   ║·  ·║   ║     ·║
║······║   ║····║   ║······║
╚══════╝   ╚══╗ ║   ╚══════╝
