6 38x21 FLIP_TO=3 READY=" READY! " GAMEOVER="ALL GONE" PLAYER1="PLAYER 1" PLAYER2="PLAYER 2" WALL_COLORS="\x04\x04\x09\x02\x03\x09" MORTAR_COLORS="\x03\x03\x07\x0E\x07\x07" DOT_COLORS="\x0E\x0E\x07\x0F\x0E\x07" RGHOST=9.5 ROGHOST=1 RFRUIT=11.5 RTOP=7.5 RHERO=11.5 RMSG=11 CMSG=15 RMSG2=7 CMSG2=15 ABOUT="Inspired by Thunder Mountain's Jr. Pac-Man conversion"
┌╒═══════╕╒════════════════╕╒═══════╕┐
││·······││················││·······││
││·┌┐·╞╡·└┘·╞╡·┌┐·╞╡·┌┐·╞╡·└┘·╞╡·┌┐·││
││■││··········││····││··········││■││
││·│╞══╡·╞══╕╒═╛┘·┌┐·└╘═╕╒══╡·╞══╡│·││
││·││·······││····││····││·······││·││
││·└┘·┌┐·╞╡·└┘·╞══╛╘══╡·└┘·╞╡·┌┐·└┘·││
││····││·······        ·······││····││
││·╞╡·│╞══╡·┌┐ ╔══≡≡══╗ ┌┐·╞══╡│·╞╡·││
││····││····││ ║      ║ ││····││····││
││·┌╒═╛┘·╞══╛┘ ╚══════╝ └╘══╡·└╘═╕┐·││
││·││··········        ··········││·││
││·└┘·┌┐·┌╒══╡·┌╒════╕┐·╞══╕┐·┌┐·└┘·││
││····││·││■···││····││···■││·││····││
││·┌┐·└┘·└┘·┌┐·└┘·┌┐·└┘·┌┐·└┘·└┘·┌┐·││
││·││·······││····││····││·······││·││
││·│╞══╡·╞══╛╘═╕┐·└┘·┌╒═╛╘══╡·╞══╡│·││
││■││··········││····││··········││■││
││·└┘·╞╡·┌┐·╞╡·└┘·╞╡·└┘·╞╡·┌┐·╞╡·└┘·││
││·······││················││·······││
└╘═══════╛╘════════════════╛╘═══════╛┘
┌╒═════════════╕╒════╕╒═════════════╕┐
││·············││····││·············││
││·┌┐·╞══╕╒══╡·└┘·┌┐·└┘·╞══╕╒══╡·┌┐·││
││·││■···││·······││·······││···■││·││
││·│╞══╡·└┘·┌┐·╞══╛╘══╡·┌┐·└┘·╞══╡│·││
││·││·······││··········││·······││·││
││·└┘·┌┐·╞══╡│ ╞══════╡ │╞══╡·┌┐·└┘·││
││····││····││          ││····││····││
││·╞══╡╞══╡·└┘ ╔══≡≡══╗ └┘·╞══╡╞══╡·││
││····││■···   ║      ║   ···■││····││
│╞══╡·└┘·┌┐·╞╡ ╚══════╝ ╞╡·┌┐·└┘·╞══╡│
││·······││····        ····││·······││
││·┌┐·╞══╡╞══╡·╞══════╡·╞══╡╞══╡·┌┐·││
││·││····││················││····││·││
││·│╞══╡·└┘·┌┐·╞══╕╒══╡·┌┐·└┘·╞══╡│·││
││·││■······││····││····││······■││·││
││·└┘·┌┐·╞══╛╘═╕┐·└┘·┌╒═╛╘══╡·┌┐·└┘·││
││····││·······││····││·······││····││
││·╞╡·└╘══╡·┌┐·└┘·╞╡·└┘·┌┐·╞══╛┘·╞╡·││
││··········││··········││··········││
└╘══════════╛╘══════════╛╘══════════╛┘
┌╒═══════╕╒════════════════╕╒═══════╕┐
││·······││················││·······││
││·┌┐·╞╡·└┘·╞╡·┌┐·╞╡·┌┐·╞╡·└┘·╞╡·┌┐·││
││■││··········││····││··········││■││
││·│╞══╡·╞══╕╒═╛┘·┌┐·└╘═╕╒══╡·╞══╡│·││
││·││······■││····││····││■······││·││
││·└┘·┌┐·╞╡·└┘·╞══╛╘══╡·└┘·╞╡·┌┐·└┘·││
││····││·······        ·······││····││
││·╞╡·│╞══╡·╞╡·╔══≡≡══╗·╞╡·╞══╡│·╞╡·││
││····││······ ║      ║ ······││····││
││·┌╒═╛┘·╞═══╡·╚══════╝·╞═══╡·└╘═╕┐·││
││·││··········        ··········││·││
││·└┘·┌┐·┌╒══╡·┌┐·╞╡·┌┐·╞══╕┐·┌┐·└┘·││
││····││·││■···││····││···■││·││····││
││·┌┐·└┘·└┘·┌┐·└╘═╕╒═╛┘·┌┐·└┘·└┘·┌┐·││
││·││·······││····││····││·······││·││
││·│╞══╡·╞══╛╘═╕┐·└┘·┌╒═╛╘══╡·╞══╡│·││
││■││··········││····││··········││■││
││·└┘·╞╡·┌┐·╞╡·└┘·╞╡·└┘·╞╡·┌┐·╞╡·└┘·││
││·······││················││·······││
└╘═══════╛╘════════════════╛╘═══════╛┘
┌╒══════════╕╒══════════╕╒══════════╕┐
││··········││··········││··········││
││·┌┐·╞═══╡·└┘·┌┐·┌┐·┌┐·└┘·╞═══╡·┌┐·││
││■││··········││·││·││··········││■││
││·└┘·╞═══╡·┌╒═╛┘·└┘·└╘═╕┐·╞═══╡·└┘·││
││··········││   ····   ││··········││
││·┌┐·╞══╕┐·└┘ ╞══════╡ └┘·┌╒══╡·┌┐·││
││·││····││·              ·││····││·││
││·└┘·┌┐·└┘·┌┐ ╔══≡≡══╗ ┌┐·└┘·┌┐·└┘·││
││····││····││ ║      ║ ││····││····││
││·╞══╛╘══╡■││ ╚══════╝ ││■╞══╛╘══╡·││
││··········││          ││··········││
││·┌┐·╞══╕┐·└┘ ╞══╕╒══╡ └┘·┌╒══╡·┌┐·││
││·││····││·······││·······││····││·││
││·└╘═╕┐·└┘·╞═══╡·└┘·╞═══╡·└┘·┌╒═╛┘·││
││····││······················││····││
││·┌┐·└┘·┌┐·┌┐·╞══╕╒══╡·┌┐·┌┐·└┘·┌┐·││
││■││····││·││····││····││·││····││■││
││·└┘·┌┐·└┘·└┘·┌┐·└┘·┌┐·└┘·└┘·┌┐·└┘·││
││····││·······││····││·······││····││
└╘════╛╘═══════╛╘════╛╘═══════╛╘════╛┘
   ┌╒════════════════════════════╕┐   
   ││····························││   
┌╒═╛┘·┌╒══╡·┌┐·╞══╕╒══╡·┌┐·╞══╕┐·└╘═╕┐
││···■││····││····││····││····││■···││
││·┌╒═╛┘·╞══╡╞══╡·││·╞══╡╞══╡·└╘═╕┐·││
││·││·······││····││····││·······││·││
││·└┘·┌───┐·└┘·╞══╛╘══╡·└┘·┌───┐·└┘·││
││····│   │····        ····│   │····││
││·┌┐·└───┘·┌┐ ╔══≡≡══╗ ┌┐·└───┘·┌┐·││
││·││·······││ ║      ║ ││·······││·││
││·└╘══╡·┌╒═╛┘ ╚══════╝ └╘═╕┐·╞══╛┘·││
││·······││                ││·······││
││·╞═══╡·└┘ ┌╒══╡ ┌┐ ╞══╕┐ └┘·╞═══╡·││
││··········││····││····││··········││
││·┌╒═════╡·└┘·┌┐·└┘·┌┐·└┘·╞═════╕┐·││
││·││··········││····││··········││·││
││·││·╞═══╡·┌╒═╛┘·┌┐·└╘═╕┐·╞═══╡·││·││
││■││·······││····││····││·······││■││
││·└┘·┌┐·╞══╛┘·╞══╛╘══╡·└╘══╡·┌┐·└┘·││
││····││······················││····││
└╘════╛╘══════════════════════╛╘════╛┘
┌╒══════════╕╒════╕╒════╕╒══════════╕┐
││··········││····││····││··········││
││·┌╒════╕┐·││·╞╡·└┘·╞╡·││·┌╒════╕┐·││
││·││····││·││··········││·││····││·││
││·││·╞╡·└┘·│╞══╡·┌┐·╞══╡│·└┘·╞╡·││·││
││·││···■···││····││····││···■···││·││
││·└╘══╡·╞══╡│·╞══╛╘══╡·│╞══╡·╞══╛┘·││
││··········││·        ·││··········││
│╞═════╡·┌┐·└┘·╔══≡≡══╗·└┘·┌┐·╞═════╡│
││·······││····║      ║····││·······││
││·╞═══╡·│╞══╡ ╚══════╝ ╞══╡│·╞═══╡·││
││·······││····        ····││·······││
│╞═════╡·└┘·┌┐·╞══════╡·┌┐·└┘·╞═════╡│
││··········││··········││··········││
││·┌╒══╡·╞══╡│·╞══╕╒══╡·│╞══╡·╞══╕┐·││
││·││···■···││····││····││···■···││·││
││·││·╞╡·┌┐·│╞══╡·└┘·╞══╡│·┌┐·╞╡·││·││
││·││····││·││··········││·││····││·││
││·└╘════╛┘·││·╞╡·┌┐·╞╡·││·└╘════╛┘·││
││··········││····││····││··········││
└╘══════════╛╘════╛╘════╛╘══════════╛┘
