7 37x21 FLIP_TO=3 READY="READY" GAMEOVER="GONE." PLAYER1="P ONE" PLAYER2="P TWO" WALL_COLORS="\x09\x04\x03\x02\x09\x04\x09" MORTAR_COLORS="\x07\x03\x07\x0E\x03\x03\x07" DOT_COLORS="\x07\x0E\x0E\x0F\x0F\x0E\x07" RGHOST=9.5 ROGHOST=2 COGHOST=1 RFRUIT=11.5 RTOP=8.5 RHERO=15.5 RMSG=11 CMSG=16 RMSG2=7 CMSG2=16 ABOUT="Inspired by GCC/Bally Midway's Jr. Pac-Man (maze slightly reduced)"
╔═════════╦═══════╦═══════╦═════════╗
║·········║·······║·······║·········║
║·╥·╞═╡·╥·╨·╥ ╞═╗·║·╔═╡ ╥·╨·╥·╞═╡·╥·║
║■║·····║···║···║·║·║···║···║·····║■║
║·╨·╞═╡·║·╔═╝·╥·╨·╨·╨·╥·╚═╗·║·╞═╡·╨·║
║· ·····║·║···║·······║···║·║····· ·║
║·╥·╞═╗·╨·╨·╞═╝ ╞═══╡ ╚═╡·╨·╨·╔═╡·╥·║
║·║···║· ·····         ····· ·║···║·║
║·╨·╥·╨·╥·╞═╡·╥ ╔═≡═╗ ╥·╞═╡·╥·╨·╥·╨·║
║···║···║··■··║ ║   ║ ║··■··║···║···║
║·╞═╩═╡·║·╞═╡·╨ ╚═══╝ ╨·╞═╡·║·╞═╩═╡·║
║· ·····║·····         ·····║····· ·║
║·╥·╞═╗·║·╥ ╞═╡ ╞═╦═╡ ╞═╡ ╥·║·╔═╡·╥·║
║·║···║·║·║  ·····║·····  ║·║·║···║·║
║·╚═╡·╨·╨·╚═╡·╞═╡·╨·╞═╡·╞═╝·╨·╨·╞═╝·║
║················· ·················║
║·╥·╔═╡ ╞═╡·╥·╥ ╞═╦═╡ ╥·╥·╞═╡ ╞═╗·╥·║
║■║·║····· ·║·║···║···║·║· ·····║·║■║
║·╨·╨·╞═╡·╥·╨·╨·╥·╨·╥·╨·╨·╥·╞═╡·╨·╨·║
║·········║·····║···║·····║·········║
╚═════════╩═════╩═══╩═════╩═════════╝
  ╔═══════════════════════════════╗  
  ║·······························║  
╔═╝·╞═══╗·╥·╞═╡·╞═╦═╡·╞═╡·╥·╔═══╡·╚═╗
║·······║·║·······║·······║·║·······║
║■╞═══╗·╨·╚═════╡·║·╞═════╝·╨·╔═══╡■║
║·····║· ·········║········· ·║·····║
║·╞═╗·║·╥·╞═══╗·╞═╩═╡·╔═══╡·╥·║·╔═╡·║
║···║·║·║·····║·     ·║·····║·║·║···║
║·╥·╨·╨·╨·╥·╥·║·╔═≡═╗·║·╥·╥·╨·╨·╨·╥·║
║·║··· ···║■║·║·║   ║·║·║■║··· ···║·║
║·╚═╗·╞═╗·║·║·╨·╚═══╝·╨·║·║·╔═╡·╔═╝·║
║···║···║·║·║···     ···║·║·║···║···║
║·╥·╚═╗·╨·║·╚═══╡ ╥ ╞═══╝·║·╨·╔═╝·╥·║
║·║···║···║·····  ║  ·····║···║···║·║
║·╨ ╥·╚═╡·╨·┌─┐·╞═╩═╡·┌─┐·╨·╞═╝·╥ ╨·║
║···║····· ·│ │··· ···│ │· ·····║···║
╠═╡·║·╔═╡·╥·└─┘·╥·╥·╥·└─┘·╥·╞═╗·║·╞═╣
║···║·║···║·····║·║·║·····║···║·║···║
║■╞═╝·╨·╥·╚═╡ ╞═╝·╨·╚═╡ ╞═╝·╥·╨·╚═╡■║
║·······║···················║·······║
╚═══════╩═══════════════════╩═══════╝
╔═══════════╦═════╦═════╦═══════════╗
║···········║·····║·····║···········║
║·╔═╡·╥·╥·•·╨·╥·•·╨·•·╥·╨·•·╥·╥·╞═╗·║
║■║···║·║·····║·······║·····║·║···║■║
║·╨·╞═╣·╚═╡·╞═╣ ╞═╦═╡ ╠═╡·╞═╝·╠═╡·╨·║
║·····║····■  ║   ║   ║  ■····║·····║
║·╞═╗·╚═╡·╥·╥ ╚═╡ ╨ ╞═╝ ╥·╥·╞═╝·╔═╡·║
║···║·····║·║           ║·║·····║···║
║·╥·╠═╡·╞═╣·╚═╡ ╔═≡═╗ ╞═╝·╠═╡·╞═╣·╥·║
║·║·║·····║···  ║   ║  ···║·····║·║·║
║·╨·╨·╞═╗·╚═╡·╥ ╚═══╝ ╥·╞═╝·╔═╡·╨·╨·║
║·······║·····║       ║·····║·······║
║·╥·╞═╗·╠═╡·╞═╣ ╞═╦═╡ ╠═╡·╞═╣·╔═╡·╥·║
║·║···║·║·····║   ║   ║·····║·║···║·║
║·╚═╡·╨·╨·╞═╗·╚═╡ ╨ ╞═╝·╔═╡·╨·╨·╞═╝·║
║···········║····· ·····║···········║
╠═╡·╥·╥·╞═╗·╠═╡·╥·•·╥·╞═╣·╔═╡·╥·╥·╞═╣
║···║·║···║·║···║···║···║·║···║·║···║
║■╞═╝·╚═╡·╨·╨·╞═╝·╥·╚═╡·╨·╨·╞═╝·╚═╡■║
║·················║·················║
╚═════════════════╩═════════════════╝
  ╔═══════╦═══════════════╦═══════╗  
  ║·······║···············║·······║  
╔═╝·╥·╥ •·╨·•·╥·╥·╥·╥·╥·•·╨·• ╥·╥·╚═╗
║■··║·║··· ···║·║·║·║·║··· ···║·║··■║
║·╞═╝·║·╔═════╝·╨·║·╨·╚═════╗·║·╚═╡·║
║·····║·║·········║·········║·║·····║
╠═══╗·║·╨·╞═══╦═╡ ╨ ╞═╦═══╡·╨·║·╔═══╣
║···║·║·······║       ║·······║·║···║
║·╥·╨·╚═╡·╥·╥·╨ ╔═≡═╗ ╨·╥·╥·╞═╝·╨·╥·║
║·║······■║·║·  ║   ║  ·║·║■······║·║
║·╚═════╗·║·╨·╥ ╚═══╝ ╥·╨·║·╔═════╝·║
║·······║·║···║       ║···║·║·······║
║·╞═══╗·║·╚═══╩═╗ ╥ ╔═╩═══╝·║·╔═══╡·║
║·····║·║·······║ ║ ║·······║·║·····║
╠═══╡·╨·╨·╞═══╗·╨ ╨ ╨·╔═══╡·╨·╨·╞═══╣
║········· ···║··· ···║··· ·········║
║·╥·╥·╥·╥·╥·╥·║ ╥·╥·╥ ║·╥·╥·╥·╥·╥·╥·║
║·║·║·║·║·║·║·║ ║·║·║ ║·║·║·║·║·║·║·║
║·╨·╨·╨·╨·║·╨·╨ ╨·║·╨ ╨·╨·║·╨·╨·╨·╨·║
║■········║·······║·······║········■║
╚═════════╩═══════╩═══════╩═════════╝
╔═══════╦═══╦═══════════╦═══╦═══════╗
║·······║···║···········║···║·······║
║·╞═╡·╥·╨·╥·╨·╞═╡·╥·╞═╡·╨·╥·╨·╥·╞═╡·║
║··■··║···║·······║·······║···║··■··║
║·╥·╥·╨·╞═╝·╞═╡ ╥·╨·╥ ╞═╡·╚═╡·╨·╥·╥·║
║·║·║· · ·····  ║···║  ····· · ·║·║·║
║·╨·╨·╥·╥·╞═╡·╥ ╚═══╝ ╥·╞═╡·╥·╥·╨·╨·║
║··· ·║·║·····║       ║·····║·║· ···║
╠═╡·╥·╨·╨·╥·╥·╨ ╔═≡═╗ ╨·╥·╥·╨·╨·╥·╞═╣
║···║· · ·║■║·  ║   ║  ·║■║· · ·║···║
║·╥·╨·╥·╥·╨·╨·╥ ╚═══╝ ╥·╨·╨·╥·╥·╨·╥·║
║·║· ·║·║·····║       ║·····║·║· ·║·║
║·╨·╥·╨·╨·╞═╡·╚═╡ ╥ ╞═╝·╞═╡·╨·╨·╥·╨·║
║···║··· ·····    ║    ····· ···║···║
╠═╡·╨·╥·╞═╡ ╞═╡ ╞═╩═╡ ╞═╡ ╞═╡·╥·╨·╞═╣
║·····║·········     ·········║·····║
║·╔═╡·╨·╥·╞═╡·╥·╞═╦═╡·╥·╞═╡·╥·╨·╞═╗·║
║·║····■║· ···║···║···║··· ·║■····║·║
║·╨·╞═╡·╨·╥·╞═╩═╡·╨·╞═╩═╡·╥·╨·╞═╡·╨·║
║·········║···············║·········║
╚═════════╩═══════════════╩═════════╝
╔═══╦═════╦═══════╦═══════╦═════╦═══╗
║···║·····║·······║·······║·····║···║
║·╥·╨·╥·╥·╨·╥·╥·╥·╨·╥·╥·╥·╨·╥·╥·╨·╥·║
║·║···║·║···║·║·║···║·║·║···║·║···║·║
║·╚═╦═╝·╚═╦═╝·╨·╚═╦═╝·╨·╚═╦═╝·╚═╦═╝·║
║···║··■··║·····  ║  ·····║··■··║···║
║·╥·╨·╥·╥·╨·╥·╔═╡ ╨ ╞═╗·╥·╨·╥·╥·╨·╥·║
║·║···║·║···║·║       ║·║···║·║···║·║
║·╚═╦═╝·╚═╦═╝·╨ ╔═≡═╗ ╨·╚═╦═╝·╚═╦═╝·║
║···║·····║···  ║   ║  ···║·····║···║
╠═╡·╨·╔═╡·╨·╞═╗ ╚═══╝ ╔═╡·╨·╞═╗·╨·╞═╣
║·····║··· ···║       ║··· ···║·····║
║·╥·╞═╣·╞═══╡·╠═╡ ╥ ╞═╣·╞═══╡·╠═╡·╥·║
║·║···║··· ···║   ║   ║··· ···║···║·║
║·╨·╥·╚═╡·╥·╞═╝ ╔═╩═╗ ╚═╡·╥·╞═╝·╥·╨·║
║···║■····║·····║   ║·····║····■║···║
║·╞═╝·╥·╔═╩═╗·╥ ╨ ╥ ╨ ╥·╔═╩═╗·╥·╚═╡·║
║·····║·║···║·║···║···║·║···║·║·····║
║·╞═╡·║·╨·╥·╨·║·╞═╩═╡·║·╨·╥·╨·║·╞═╡·║
║·····║···║···║·······║···║···║·····║
╚═════╩═══╩═══╩═══════╩═══╩═══╩═════╝
╔═══════╦═══╦═══╦═══╦═══╦═══╦═══════╗
║·······║···║···║···║···║···║·······║
║·╔═══╗·║·╥·╨·╥·╨·╥·╨·╥·╨·╥·║·╔═══╗·║
║·║···║·║·║· ·║···║···║· ·║·║·║···║·║
║·║·•·╨·║·╨·╥·╚═╡·║·╞═╝·╥·╨·║·╨·•·║·║
║·║··■··║···║·····║·····║···║··■··║·║
║·╚═╡·•·╨·╞═╣·╔═╡ ╨ ╞═╗·╠═╡·╨·•·╞═╝·║
║···········║·║       ║·║···········║
╠═════╗·╥·•·╨·╨ ╔═≡═╗ ╨·╨·•·╥·╔═════╣
║·····║·║·····  ║   ║  ·····║·║·····║
║·╞═╡·╨·║·╞═══╡ ╚═══╝ ╞═══╡·║·╨·╞═╡·║
║·······║·····         ·····║·······║
╠═════╡·╨·•·╥·╔═╡ ╥ ╞═╗·╥·•·╨·╞═════╣
║···········║·║   ║   ║·║···········║
║·╔═╡·•·╥·╞═╣·║ ╞═╩═╡ ║·╠═╡·╥·•·╞═╗·║
║·║··■··║···║·║··· ···║·║···║··■··║·║
║·║·•·╥·║·╥·╨·╚═╡·╥·╞═╝·╨·╥·║·╥·•·║·║
║·║···║·║·║· ·····║····· ·║·║·║···║·║
║·╚═══╝·║·╨·╥·╞═══╩═══╡·╥·╨·║·╚═══╝·║
║·······║···║···········║···║·······║
╚═══════╩═══╩═══════════╩═══╩═══════╝
