1 30x22 RMSG2=7 CMSG2=10 RMSG=13 CMSG=10 RTOP=8.5 RGHOST=11.5 RFRUIT=13.5 RHERO=20.5 ABOUT="Inspired by Greg Dionne's Pac-Man clone for the MC-10"
╔════════════════════════════╗
║····························║
║·┌───┐·┌┐·┌──────┐·┌┐·┌───┐·║
║·└───┘·││·└──┐┌──┘·││·└───┘·║
║···■···││····││····││···■···║
║·┌───┐·│└──┐ ││ ┌──┘│·┌───┐·║
║·└───┘·│┌──┘ └┘ └──┐│·└───┘·║
║·······││          ││·······║
╚══╗·┌┐·││ ╔══≡≡══╗ ││·┌┐·╔══╝
═══╝·││·└┘ ║      ║ └┘·││·╚═══
    ·││·   ║      ║   ·││·    
═══╗·││·┌┐ ║      ║ ┌┐·││·╔═══
╔══╝·└┘·││ ╚══════╝ ││·└┘·╚══╗
║·······││          ││·······║
║·┌───┐·││ ┌──────┐ ││·┌───┐·║
║·└───┘·└┘ └──┐┌──┘ └┘·└───┘·║
║·············││·············║
║·┌┐·┌┐·┌───┐·││·┌───┐·┌┐·┌┐·║
║·││■││·│   │·││·│   │·││■││·║
║·└┘·││·└───┘·└┘·└───┘·││·└┘·║
║····││·······  ·······││····║
╚════╛╘════════════════╛╘════╝
