1 28x25 RGHOST=12.5 ROGHOST=2 COGHOST=2.5 RFRUIT=14.5 RTOP=11 RHERO=17.5 RMSG=24 RMSG2=0 ABOUT="Inspired by 'Muncher', Bally's unreleased Astrocade Pac-Man conversion"
╔════════════╕╒════════════╗
║············││············║
║■┌──┐·┌───┐·││·┌───┐·┌──┐■║
║·└──┘·└───┘·└┘·└───┘·└──┘·║
║··························║
║·┌──┐·┌┐·┌──────┐·┌┐·┌──┐·║
║·└──┘·││·└──┐┌──┘·││·└──┘·║
║······││····││····││······║
╚════╗·│└──┐·││·┌──┘│·╔════╝
     ║·│┌──┘·└┘·└──┐│·║     
═════╝·└┘          └┘·╚═════
      ·   ╔══≡≡══╗   ·      
═════╗·┌┐ ║      ║ ┌┐·╔═════
╔════╝·└┘ ╚══════╝ └┘·╚════╗
║············  ············║
║·┌──┐·┌───┐·┌┐·┌───┐·┌──┐·║
║·└─┐│·└───┘·└┘·└───┘·│┌─┘·║
║■··││·······  ·······││··■║
╙─┐·││·┌┐·┌──────┐·┌┐·││·┌─╜
╓─┘·└┘·││·└──┐┌──┘·││·└┘·└─╖
║······││····││····││······║
║·┌────┘└──┐·││·┌──┘└────┐·║
║·└────────┘·└┘·└────────┘·║
║··························║
╚══════════════════════════╝
