9 28x29 RGHOST=15.5,12.5,27.5,8.5,11.5,25.5,15.5,24.5,27.5 CGHOST=14,14,3,26,25.5,3,14,20,3.5 RTOP=13.5,10.5,25.5,4.5,22.5,24.5,13.5,23.5,25.5 COGHOST=1.5,1.5,1.5,0.5,1,0.5,1.5,0.5,2 ROGHOST=1,1,1,3,3,1,1,1,1 RMSG=17,14,0,28,28,28,17,28,28 CMSG=9,9,0,0,0,0,9,0,0 RMSG2=12,9,0,28,28,28,12,28,28 CMSG2=9,9,18,18,18,18,9,18,18 RFRUIT=17.5,14.5,24.5,10.5,13.5,27.5,17.5,26.5,1.5 CFRUIT=14,14,2.5,27.5,25.5,3,14,20,10.5 RHERO=22.5,21.5,5.5,14.5,27.5,1.5,22.5,10.5,1.5 CHERO=14.5,13.5,11.5,22.5,19.5,16.5,14.5,11.5,10.5 PELLET_COLORS="\x09" MORTAR_COLORS="\x0f" WALL_COLORS="\x0f" ABOUT="Inspired by The Rev Dr. Mike/Michael Billars's 'Pacman for Console'"
╔════════════╕╒════════════╗
║············││············║
║·┌──┐·┌───┐·││·┌───┐·┌──┐·║
║■│  │·│   │·││·│   │·│  │■║
║·│  │·│   │·││·│   │·│  │·║
║·└──┘·└───┘·└┘·└───┘·└──┘·║
║··························║
║·┌──┐·┌┐·┌──────┐·┌┐·┌──┐·║
║·└──┘·││·└──┐┌──┘·││·└──┘·║
║······││····││····││······║
╚════╗·│└──┐ ││ ┌──┘│·╔════╝
     ║·│┌──┘ └┘ └──┐│·║     
     ║·││          ││·║     
     ║·││ ╔══≡≡══╗ ││·║     
═════╝·└┘ ║      ║ └┘·╚═════
      ·   ║      ║   ·      
═════╗·┌┐ ╚══════╝ ┌┐·╔═════
     ║·││          ││·║     
╔════╝·└┘ ╞══╕╒══╡ └┘·╚════╗
║············││············║
║·┌──┐·┌───┐·││·┌───┐·┌──┐·║
║·└─┐│·└───┘·└┘·└───┘·│┌─┘·║
║■··││········ ·······││··■║
╙─┐·││·┌┐·┌──────┐·┌┐·││·┌─╜
╓─┘·└┘·││·└──┐┌──┘·││·└┘·└─╖
║······││····││····││······║
║·╞════╛╘══╡·└┘·╞══╛╘════╡·║
║··························║
╚══════════════════════════╝
╔═══════╗   ║ ║   ╔════════╗
║······■║   ║·║   ║■·······║
║·┌───┐·║   ║·║   ║·┌────┐·║
║·│   │·╚═══╝·╚═══╝·│    │·║
║·└───┘·············└────┘·║
║·······╞═══╡·╞═══╡········║
║·┌───┐·············┌────┐·║
║·└───╘╡·┌──┐ ┌───┐·└────┘·║
║········╓──┘ └───╖········║
╚══╗·┌─┐·║        ║·┌─┐·╔══╝
   ║·│ │·║ ╔═≡≡═╗ ║·│ │·║   
   ║·│ │·╨ ║    ║ ╨·│ │·║   
   ║·│ │·■ ║    ║ ■·│ │·║   
═══╝·└─┘·╥ ╚═≡≡═╝ ╥·└─┘·╚═══
 ········║        ║········ 
═══╗·┌─┐·╙───┐ ┌──╜·┌─┐·╔═══
   ║·└─┘·└───┘ └──┘·└─┘·║   
   ║····················║   
   ║·┌───┐·┌────┐·┌───┐·║   
   ║·│   │·│    │·│   │·║   
╔══╝·└───┘·└────┘·└───┘·╚══╗
║············ ············■║
║·╥·╔═══════╡·╞════════╗·╥·║
║·╨·║··················║·╨·║
║··■║·╥·╔═══╗·┌───┐·┌┐·║···║
║·┌─╜·║·║   ║·│   │·││·╙─┐·║
║·└─┘·╨·║   ║·└───┘·││·└─┘·║
║·······║   ║·······││·····║
╚═══════╝   ║ ╔═════╛╘═════╝
════════════╝ ╠═════════════
 ·············║·········■·· 
┐·┌──┐·┌──┐·╥·║·╞═══╦══╡·╞═╕
│·│  │·│  │·║·║·····║······│
│·└──┘·└──┘·║·╨·╞═╡·║·┌──┐·│
│·········· ║·······║·│  │·│
│·╞══╗·╞══╡·╚═════╡·║·│  │·│
│····║··············║·└──┘·│
│·╔╡·╚════════════╡·║······│
│·║·················╚╡·┌┐·╞╡
│·╨·╞═══╡·╞═════╗·╥····││··│
│···■···········║·║·╥·╞╛╘╗·│
┘·╥·╞═════════╗·║·║·║····║·└
 ·║···········║·╨·╨·╚══╗·║· 
╒═╝·╞═╦═══╗·╥·║········║·║·┌
│·····╨···║·║·╚╗·┌─┐·╥·╨·║·│
│·┌─┐···╥·║·╨··╨·│ │·║···╨·│
│·│ │·╥·║·║··╥···│ │·║·╥■··│
│·└─┘·║·║·╚╡·╚═══╡ │·║·╚═╡·│
│■····║·║········└─┘·║·····│
╘═════╝·╨·╞════╡·····║·╞═══╛
 ············■···╥·╥·║····· 
═════╗·┌──┐·╞══╡·║·║·╚═══╡·╔
  ╞══╝·│  │······║·║·······║
 ╥    ·│  │·╔══╡·║·╨·╞═════╣
╔╩≡══╗·│  │·║····║·········║
║    ║·└──┘·╨·╞══╩═╡·╞═══╡·║
║    ║····················■║
╚════╩══════╗ ╔════════════╝
╝ ║   ║ ╚═══╡ ╞══╝ ║ ╚══════
 ·║   ║■···········║······· 
══╬═══╝·╔══════════╩════════
 ·╨·····║···········■······ 
┐· ·╞═╡·║·┌──┐·┌──┐·╥·╔═══≡╕
│·╥·····║·└──┘·└──┘·╨·║    │
│·╚═══╗·║·············║ ╥  │
│···■·║·╙╒═══╡·╔══════╝ ╨  │
│·╥·╥·╨·╓┘·····║·······    │
┘·║·║· ·╨··╔═══╝·╞══╗·╔════╛
 ·║·╨·╥···╞╝···■····║·║···· 
══╣···║·╥····╔════╗·╨·║·╞═══
 ·╠═══╣·╚═╗·╞╝····║···║···· 
╡·║·■·║···║····┌┐·╚═╦═╩═════
 ·║·╥·╚═╗·╚══╡·││···║· ···· 
══╣·║···║······│└─┐·║·╞═════
 ·╨·╚═╡·╙───┐·╞╛──╖·║······ 
╡·······│   │·····╨·╙──╒════
══╡·╞═══╛─┐ │·╞═╡···│  │···╞
 ·········│ │····╔══╛──┘·╥· 
════════╗·└─╘══╗·║·······╠══
 ·······║······║·║■╞═══╡·║· 
══════╗·╠════╡·║·║·······║·╞
 ·····║·╨······║·║·╔═══╗·║· 
════╡■║···╥·╥·┌╜·║·║···║·╠══
 ·····║·╥·║·║·││·║·║·╥·║·║· 
╦═════╝·║·╨·║·└┘·║·║·║·╨·╨·╔
║·······║···║····║·║·║·····║
║ ╔═══╗ ╠═══╝ ╞══╣ ║ ╠═════╝
╔════════════╝ ╚═══════════╗
║··························║
║·╔═╡··╥···╥··╞═╡·╥··╥·┌─┐·║
║·║  ╥·║···║·•····║··║·│ │·║
║·╠══╣·║···║··╞╡··╠══╣·│ │·║
║·║  ╨·╨···╨··■·•·║··║·└─┘·║
║·╚═╡···╞═╡··╞═╡··╨··╨·····║
║····················· ╞═══╣
╚══╗·╞══════════════╡·     ║
   ║··················     ║
   ║·╞══╡·╥·╔═╡·╥·┌──┐     ║
   ║······║·║···║·│  │     ║
═══╝·╞══╡·║·║·╥·║·│  │ ╞═══╩
 ·········║·║·║·║·╓──┘····· 
═══╗·╔══╡·╨·╨·╨·╨·╨····╞═══╦
   ║·║·······■······┌┐·····║
   ║·║·┌───────┐·╔══╛┘·╞═╗·║
   ║·║·│       │·║·······║·║
╔══╝·║·└───────┘·╨·╞═╡·•·║·║
║····║···················║·║
║·╞══╩═════╡·╞══════╡·╞══╝·║
║··························║
║··╞═╡·╥···╥··╞═╡·╥··•··╞══╣
║·•····║·■·║·╥····║·•··•   ║
║··╞╡··║···║·║····╠╡····╞╡ ║
╝····•·╨···╨·╨····║·•·····╞╩
 ·╞═╡···╞═╡···╞═╡·╨··•·╞═╡· 
╗·····■············ ······■╔
╚════════════╗ ╔═══════════╝
══╣ ╨ ║ ║ ╚══════╣ ║ ║ ╠════
 ·║···║·║······· ║·║·║·║■·· 
┐·╚═╡·║·╠═════╗·╔╝·║·║·║·╥·┌
│·····║·║·····║·║··╨·║·║·║·│
│·╔═══╝·║·╔═╗·║·║·╥··║·║·║·│
│·║·····║·║·║·╨·╨·║·╞╝·║·╨·│
│·║·╔═══╝·║·║·····║····║···│
┘·║·║■····║·╚═╡·╔═╩═══╦╩═══╛
 ·║·║·╔═╡·╨·····║··■··║···· 
══╝·║·║·····╔═══╣·╞═╡·║·╞╦══
 ···║·║·╥·╔═╝···║·····║··║· 
╒═══╝·║·║·║···╥·╚═╗·╞═╩╡·║·┌
│·····║·╨·╨·╞═╝···║······║·│
│·╔═══╝········╞╡·║·╥·╞╗·║·│
┘·╨·····╞╕─╒≡╗····║·║··║·║·└
 ···┌─┐··│ │ ╙─╒══╝·╚╡·╨·║· 
╒═══╛─╘╗·└─╘≡╛─┘·········║·┌
│·····■║·········╥·╞═╦═╗·║·│
│·╞══╗·╠═╡·╞╡·╞══╝···║ ║·║·│
│····║·║···········╥·╠≡╣·║·│
╘══╡·║·║·╞╡·╔═╡·╞══╝·╨ ╨·║·└
 ····║·║····║············║· 
═╦═╡·║·╠══╡·║·╞╡·╔═══════╩═╦
 ║···║·║····║····║·········║
 ╠≡≡╗║·║·╥·╞╩══╡·║·╔═════╡·║
 ║  ║╨·║·║···■···║·║···■···║
═╩══╣··╨·╚╗·╞══╡·║·║·╔═════╩
 ···║·╥···║······║·║·║····· 
══╗ ║ ║ ╥ ╠══════╣ ║ ║ ╔════
╔═══════════╡ ╞════════════╗
║············  ············║
║·┌──┐·┌┐ ┌┐·╞╡·┌┐ ┌┐·┌──┐·║
║■│  │·││ ││·  ·││ ││·│  │■║
║·│  │·││ ││·┌┐·││ ││·│  │·║
║·└──┘·└┘ └┘·└┘·└┘ └┘·└──┘·║
║··························║
║·╥ ┌┐·┌┐·┌──────┐·┌┐·┌┐ ╥·║
║·╨ └┘·││·└──┐┌──┘·││·└┘ ╨·║
║······││····││····││······║
╚════╗·│└──┐ ││ ┌──┘│·╔════╝
     ║·│┌──┘ └┘ └──┐│·║     
     ║·││          ││·║     
     ║·││ ╔══≡≡══╗ └┘·║     
═════╝·└┘ ║      ║   ·╚═════
      ·   ║      ║ ┌┐·      
═════╗·┌┐ ╚══≡≡══╝ ││·╔═════
     ║·││          ││·║     
╔════╝·└┘ ╞══════╡ └┘·╚════╗
║············  ············║
║·╥ ┌┐·┌┐ ┌┐·┌┐·┌┐ ┌┐·┌┐ ╥·║
║·╨ └┘·└┘ └┘·└┘·└┘ └┘·└┘ ╨·║
║···  ········ ·······  ···║
╙─┐·┌┐·┌┐·┌┐ ┌┐ ┌┐·┌┐·┌┐·┌─╜
╓─┘·└┘·└┘·└┘ └┘ └┘·└┘·└┘·└─╖
║······  ····  ····  ······║
║·╞══╡ ╞═══╡·╞╡·╞═══╡ ╞══╡·║
║············ ·············║
╚═══════════╡ ╞════════════╝
════════════╝ ╚════╝ ╚═╝ ╨ ╚
 ··········· · · ········ · 
┐ ╥ ╞═╦═══╗·╥·╥·╥·╔══════╡ ┌
│ ║···║···║·║·║·║·║···┌┐···│
│ ║·╥·║·╥·║·║·║·║·║·╥·╓┘·╥·│
╞≡╝·║·╨·║·╨·║·║·╨·║·║·║ ·║·│
│  ·║···║···║·║· ·║·║·║··║·│
╞≡╡·╨ ╞═╝ ╔═╝·║·╥·║·║·║· ║·│
│·········║···║·║·║·║·║··║·│
│·╞═════╡·╨·╞═╝·║·║·║·║ ·╨·│
│·········· ····║·║·║·║·· ·│
│·╔═══════╗·╥ ╔═╝·║·║·║·╔╡·│
│·║·······║·║ ╨···║·║·╨·║··│
│·║·╥ ╞═╗·║·║···╔═╝·║···║·┌┘
│·║·╨···║·╨·║·╞═╣···║ ╞═╣·└┐
│·║···╥·║· ·║···║·╔═╝···╨··│
│·╚═╡ ╨·║·╥·╚═╡·║·║···╥··╥·│
│·······║·║·····║·║·┌─╨┐·║·│
│·╞═══╡ ╨·║·╞═══╝·║·│  │·║·│
│·········║· ·····║·└╥─┘·║·│
╘═══╡ ╞═══╣·╞═══╡·╨··║···║·└
 ·········║········╥·║·╥·║· 
════╡ ╞═╡·║·╥·╥·┌┐·╨·╨·╨·╚══
 ·········║·║·║·╓┘········· 
╦═══════╡ ╨·╨·╨·║ ╔≡≡╦══╡ ╞╦
║  ········· · ·║ ║  ║·····║
╠≡════════╡·╥·╥·╚═╩══╣·╞═╗·║
║···········║·║······║···║·║
╚═══════════╣ ╠════╗ ╠═╗ ║ ║
╔══════════════════════════╗
║········· ···············■║
║·╞══════════════════════╡·║
║··························║
║·╥ ╞═══════╡ ╞══════════╡ ║
║·║························║
║·╨ ╥ • ╥ • ╔══════════╡ ╥·║
║···║···║···║············║·║
║·╥·║·╥·║·╥ ║·╔════════╡·║·║
║·║·║·║·║·║·║·║··■·······║·║
║·║·║·║·║·║·║·║·╞══╡ ╞═╡ ║·║
║■║·║·║·║·║·║·║··········║·║
║·║·║·║■║·║·║·║ ╥ ╥·╥ ╞╡ ║·║
║·║·║·║·║·║·║·║·║·║·║····║·║
║·║·║·║·║·║·║·║·║·║·║·┌┐·║·║
║·║·║·║·║·║·╨·║·║·║·║·││·║·║
║·║·║·║·║·║···║·║·║·║·││·║·║
║·║·║·║·║·║·╔═╝·║·║·║·││·║·║
║·║·║·║·║·║·║···║·║·║·││·║·║
║·║·║·║·║·║·║·╥·║·║·║·││·║·║
║·║·║·║·║·║·║·║·║·║·║·││·║·║
║·║·╨·║·╨·║·║·║·║·║·║·││·║·║
║·║···║···║·║·║·║·║·║·││·║·║
║·╨ • ╨ •·║·║·║·║·║·║·││·║·║
║·■·······║·║·║·╨·║·║·││·║·║
╠≡╦≡╦≡╦≡╗·║·║·║···║·║·││·║·║
║ ║ ║ ║ ║·╨·╨·╚═══╝·╨·└┘·╨·║
║ ║ ║ ║ ║·■· ·············■║
╚═╩═╩═╩═╩══════════════════╝
