1 28x27 \
     RTOP=12.5 \
   RGHOST=13.5 \
  ROGHOST=1    COGHOST=2.5 \
   RFRUIT=15.5 \
    RHERO=20.5 \
     RMSG=15 \
    RMSG2=11 \
    ABOUT="Inspired by a Fall 2006 Berkeley CS 188 class project's 'original' layout"
╔════════════╕╒════════════╗
║············││············║
║·┌──┐·┌───┐·││·┌───┐·┌──┐·║
║■│  │·│   │·││·│   │·│  │■║
║·└──┘·└───┘·└┘·└───┘·└──┘·║
║··························║
║·┌──┐·┌┐·┌──────┐·┌┐·┌──┐·║
║·└──┘·││·└──┐┌──┘·││·└──┘·║
║······││····││····││······║
╚════╗·│└──┐ ││ ┌──┘│·╔════╝
     ║·╓───┘ └┘ └───╖·║     
     ║·║            ║·║     
═════╝·╨ ╔═══≡≡═══╗ ╨·╚═════
      ·  ║        ║  ·      
═════╗·╥ ╚════════╝ ╥·╔═════
     ║·║            ║·║     
╔════╝·╨ ╞═══╕╒═══╡ ╨·╚════╗
║············││············║
║·┌──┐·┌───┐·││·┌───┐·┌──┐·║
║·└─┐│·└───┘·└┘·└───┘·│┌─┘·║
║■··││·······  ·······││··■║
╙─┐·││·┌┐·┌──────┐·┌┐·││·┌─╜
╓─┘·└┘·││·└──┐┌──┘·││·└┘·└─╖
║······││····││····││······║
║·╞════╛╘══╡·└┘·╞══╛╘════╡·║
║··························║
╚══════════════════════════╝
