1 29x24 READY="  READY!!  " GAMEOVER=" GAME OVER " PLAYER1="PLAYER ONE " PLAYER2="PLAYER TWO " RGHOST=12.5 ROGHOST=1.5 COGHOST=3 RFRUIT=14.5 RTOP=10 RHERO=18.5 RMSG=14 RMSG2=9 ABOUT="Inspired by a PC-6001 Pac-Man conversion"
╔════════════╗ ╔════════════╗
║············║ ║············║
║■┌──┐·┌───┐·║ ║·┌───┐·┌──┐■║
║·└──┘·└───┘·╚═╝·└───┘·└──┘·║
║···························║
║·╞══╡·┌┐·╞══╕─╒══╡·┌┐·╞══╡·║
║······││····│ │····││······║
╚════╗·│└──┐ │ │ ┌──┘│·╔════╝
     ║·│┌──┘ └─┘ └──┐│·║     
     ║·││           ││·║     
═════╝·└┘ ╔══≡≡≡══╗ └┘·╚═════
      ·   ║       ║   ·      
═════╗·┌┐ ║       ║ ┌┐·╔═════
     ║·││ ╚═══════╝ ││·║     
     ║·││           ││·║     
╔════╝·└┘ ╞══╕─╒══╡ └┘·╚════╗
║············│ │············║
║·╞═╕┐·╞═══╡·└─┘·╞═══╡·┌╒═╡·║
║■··││········ ········││··■║
╠═╡·└┘·┌┐·╞══╕─╒══╡·┌┐·└┘·╞═╣
║······││····│ │····││······║
║·╞════╛╘══╡·└─┘·╞══╛╘════╡·║
║···························║
╚═══════════════════════════╝
