6 21x27~1 FLIP_TO=2 READY=" READY!" GAMEOVER="GOODBYE" PLAYER1="PLAYER1" PLAYER2="PLAYER2" WALL_COLORS="\x0d\x03\x06\x03" MORTAR_COLORS="\x05\x09\x04\x09" DOT_COLORS="\x0f\x07\x0d\x07" RGHOST=13 ROGHOST=2.5 COGHOST=1 RFRUIT=15.5 RHERO=20.5 RMSG=15 CMSG=7 RMSG2=10 CMSG2=7 ABOUT="Inspired by Namco's Pac-Jr."
╔═══════════════════╗
║···················║
║·┌─┐·╥·┌───┐·╥·┌─┐·║
║■│ │·║·│   │·║·│ │■║
║·└─┘·╨·└───┘·╨·└─┘·║
║···················║
╚═╗·╥·┌─┐·╥·┌─┐·╥·╔═╝
  ║·║·└─┘·║·└─┘·║·║  
  ║·║·····║·····║·║  
══╝·╚═╡ ╞═╩═╡ ╞═╝·╚══
   ·             ·   
══╗·┌─┐ ╔═≡═╗ ┌─┐·╔══
  ║·╓─┘ ║   ║ └─╖·║  
  ║·║   ║   ║   ║·║  
  ║·╨ ╥ ╚═══╝ ╥ ╨·║  
══╝·  ║       ║  ·╚══
   ·┌─╨─┐ ╥ ┌─╨─┐·   
══╗·└───┘ ║ └───┘·╔══
  ║·····  ║  ·····║  
  ║·┌─┐·╞═╩═╡·┌─┐·║  
╔═╝·└─╖··· ···╓─┘·╚═╗
║·····║·┌───┐·║·····║
║·┌─┐·║·│   │·║·┌─┐·║
║■│ │·║·│   │·║·│ │■║
║·└─┘·╨·└───┘·╨·└─┘·║
║···················║
╚═══════════════════╝
╔═══════════════════╗
║···················║
║·┌─┐·╥·┌───┐·╥·┌─┐·║
║■└─┘·║·└─╥─┘·║·└─┘■║
║·····║···║···║·····║
╝·╔═══╝·╥·║·╥·╚═══╗·╚
 ·║·····║·╨·║·····║· 
╗·║·┌─┐ ║···║ ┌─┐·║·╔
║·║·│ │ ╙───╜ │ │·║·║
║·╨·└─╖ └───┘ ╓─┘·╨·║
║·····║       ║·····║
╙───┐·║ ╔═≡═╗ ║·┌───╜
╓───┘·╨ ║   ║ ╨·└───╖
║·····  ║   ║  ·····║
║·╞═╗·╥ ╚═══╝ ╥·╔═╡·║
║···║·║       ║·║···║
╚═╗·║·╙─┐ ╥ ┌─╜·║·╔═╝
  ║·╨·└─┘ ║ └─┘·╨·║  
══╝·······║·······╚══
   ·╥·╔═══╩═══╗·╥·   
╦═╡·║·║··· ···║·║·╞═╦
║···║·╨·╞═╦═╡·╨·║···║
║·┌─╜·····║·····╙─┐·║
║■│ │·┌─┐·║·┌─┐·│ │■║
║·└─┘·└─┘·║·└─┘·└─┘·║
║·········║·········║
╚═════════╩═════════╝
╔═══════╦═══╦═══════╗
║·······║···║·······║
║·┌───┐·║·╥·║·┌───┐·║
║■╓───┘·╨·║·╨·└───╖■║
║·║·······║·······║·║
║·╨·╥·┌─┐·║·┌─┐·╥·╨·║
║···║·└─┘·╨·└─┘·║···║
╙─┐·║···········║·┌─╜
╓─┘·╙─┐ ┌───┐ ┌─╜·└─╖
║···│ │ └───┘ │ │···║
║·╥·└─┘       └─┘·╥·║
║·║·    ╔═≡═╗    ·║·║
╝·╠═╡ ╥ ║   ║ ╥ ╞═╣·╚
 ·║···║ ║   ║ ║···║· 
╗·╨·╥·║ ╚═══╝ ║·╥·╨·╔
║···║·║       ║·║···║
╙───╜·╠═╡ ╥ ╞═╣·╙───╜
╓───┘·║···║···║·└───╖
║·····║·┌─╨─┐·║·····║
║·┌─┐·╨·└───┘·╨·┌─┐·║
║■│ │····· ·····│ │■║
║·└─┘·╔═╡·╥·╞═╗·└─┘·║
║·····║···║···║·····║
║·┌───╜·┌─╨─┐·╙───┐·║
║·└───┘·└───┘·└───┘·║
║···················║
╚═══════════════════╝
╔═════════╦═════════╗
║·········║·········║
║·╥·┌─┐·╥·║·╥·┌─┐·╥·║
║■║·│ │·║·╨·║·│ │·║■║
║·║·└─┘·║···║·└─┘·║·║
║·╨·····╙───╜·····╨·║
║···┌─┐·└───┘·┌─┐···║
╙─┐·│ │·······│ │·┌─╜
└─╖·└─╖·┌───┐·╓─┘·╓─┘
  ║···║·└───┘·║···║  
══╩═╡·╨       ╨·╞═╩══
   ···  ╔═≡═╗  ···   
══╗·┌─┐ ║   ║ ┌─┐·╔══
  ║·╓─┘ ║   ║ └─╖·║  
══╝·║·  ╚═══╝  ·║·╚══
   ·║·╥       ╥·║·   
══╗·╨·╠══╡ ╞══╣·╨·╔══
  ║···║·······║···║  
┌─╜·┌─╜·┌───┐·╙─┐·╙─┐
╓─┘·└─┘·╓───╖·└─┘·└─╖
║·······║· ·║·······║
║·┌─┐·╥·║·╥·║·╥·┌─┐·║
║·╓─┘·║·╨·║·╨·║·└─╖·║
║■║···║···║···║···║■║
║·╨·╞═╩═╡·║·╞═╩═╡·╨·║
║·········║·········║
╚═════════╩═════════╝
╔═══════╦═══╦═══════╗
║·······║···║·······║
║·┌───┐·║·╥·║·┌───┐·║
║■╓───┘·╨·║·╨·└───╖■║
║·║·······║·······║·║
║·╨·╥·┌─┐·║·┌─┐·╥·╨·║
║···║·└─┘·╨·└─┘·║···║
╙─┐·║···········║·┌─╜
╓─┘·╙─┐ ┌───┐ ┌─╜·└─╖
║···│ │ └───┘ │ │···║
║·╥·└─┘       └─┘·╥·║
║·║·    ╔═≡═╗    ·║·║
╝·╠═╡ ╥ ║   ║ ╥ ╞═╣·╚
 ·║···║ ║   ║ ║···║· 
╗·╨·╥·║ ╚═══╝ ║·╥·╨·╔
║···║·║       ║·║···║
╙───╜·╠═╡ ╥ ╞═╣·╙───╜
╓───┘·║···║···║·└───╖
║·····║·┌─╨─┐·║·····║
║·┌─┐·╨·└───┘·╨·┌─┐·║
║■│ │····· ·····│ │■║
║·└─┘·╔═╡·╥·╞═╗·└─┘·║
║·····║···║···║·····║
║·┌───╜·┌─╨─┐·╙───┐·║
║·└───┘·└───┘·└───┘·║
║···················║
╚═══════════════════╝
╔═════════╦═════════╗
║·········║·········║
║·╥·┌─┐·╥·║·╥·┌─┐·╥·║
║■║·│ │·║·╨·║·│ │·║■║
║·║·└─┘·║···║·└─┘·║·║
║·╨·····╙───╜·····╨·║
║···┌─┐·└───┘·┌─┐···║
╙─┐·│ │·······│ │·┌─╜
└─╖·└─╖·┌───┐·╓─┘·╓─┘
  ║···║·└───┘·║···║  
══╩═╡·╨       ╨·╞═╩══
   ···  ╔═≡═╗  ···   
══╗·┌─┐ ║   ║ ┌─┐·╔══
  ║·╓─┘ ║   ║ └─╖·║  
══╝·║·  ╚═══╝  ·║·╚══
   ·║·╥       ╥·║·   
══╗·╨·╠══╡ ╞══╣·╨·╔══
  ║···║·······║···║  
┌─╜·┌─╜·┌───┐·╙─┐·╙─┐
╓─┘·└─┘·╓───╖·└─┘·└─╖
║·······║· ·║·······║
║·┌─┐·╥·║·╥·║·╥·┌─┐·║
║·╓─┘·║·╨·║·╨·║·└─╖·║
║■║···║···║···║···║■║
║·╨·╞═╩═╡·║·╞═╩═╡·╨·║
║·········║·········║
╚═════════╩═════════╝
