13 39x24 \
 \
  FIXME="game should allow each ghost to be positioned independently" \
 \
  RHERO="14.5,16.5,14.5, 8.5, 9.5,22.5,11.5,22.5,22.5, 9.5,20.5, 8.5,12.5" \
  CHERO="18.5,18.5,20.5,26.5,34.5, 1.5,23.5,13.5,36.5,30.5,35.5, 1.5,10.5" \
 GHOSTS="   4,   4,   2,   3,   4,   3,   3,   2,   2,   3,   4,   3,   2" \
 RGHOST="10.5, 9.5,11.5,13.5,19.5, 1.5,22.5,15.5, 1.5,20.5, 6.5, 3.5,21.5" \
 CGHOST="18.5,17.5,19.5, 3.5,13.5, 1.5, 1.5,25.5, 1.5,32.5, 5.5, 1.5,34.5" \
 RGHOST="11.5, 9.5,12.5,12.5,18.5, 1.5,22.5,15.5, 1.5, 3.5,10.5, 1.5, 6.5" \
 CGHOST="17.5,18.5,23.5, 4.5,13.5,37.5,37.5,26.5,37.5,20.5,17.5,37.5,32.5" \
 RGHOST="12.5,13.5,  -1,14.5,18.5,22.5, 1.5,  -1,  -1, 3.5,20.5,21.5,  -1" \
 CGHOST="20.5,14.5,  -1, 5.5,14.5,37.5,37.5,  -1,  -1,35.5,25.5,36.5,  -1" \
 RGHOST="12.5,13.5,  -1,  -1,18.5,  -1,  -1,  -1,  -1,  -1, 2.5,  -1,  -1" \
 CGHOST="15.5,23.5,  -1,  -1,10.5,  -1,  -1,  -1,  -1,  -1,29.5,  -1,  -1" \
 RGHOST="10.5, 9.5,11.5,13.5,19.5, 1.5,22.5,15.5, 1.5,20.5, 6.5, 3.5,21.5" \
 CGHOST="18.5,17.5,19.5, 3.5,13.5, 1.5, 1.5,25.5, 1.5,32.5, 5.5, 1.5,34.5" \
   RMSG=23 CMSG=17 RMSG2=0 CMSG2=17 \
  READY="READY!" GAMEOVER=" BYE! " PLAYER1="ONE UP" PLAYER2="TWO UP" \
  ABOUT="Inspired by Arjan de Mes's PacMes"
╔═════════════════╕─╒═════════════════╗
║·················│ │·················║
║·┌──┐·┌────┐·┌─┐·│ │·╔═══╡·┌──┐·┌──┐·║
║■│  │·│┌───┘·│ │·│ │·║·····│  │·└──┘■║
║·│  │·││·····│ │·└─┘·╨·┌─┐·│  │······║
║·│  │·││·┌─┐·│ │·······│ │·│  │·┌──┐·║
║·│  │·││·│ │·│ └─────┐·│ │·│  │·│  │·║
║·│  │·││·│ │·└───────┘·│ │·│  │·│  │·║
║·└──┘·└┘·│ │···········│ │·└──┘·└──┘·║
║·········│ │·╔══╡ ╞══╗·└─┘···········║
╩════╡·┌──┘ │·║       ║·····┌──┐·╞════╩
 ······│    │·║       ║·┌───┘  │······ 
╦════╡·└──┐ │·║       ║·│     ┌┘·╞════╦
║·········└─┘·╚═══════╝·└─────┘·······║
║·┌──┐·┌┐········· ·············┌───┐·║
║·│  │·││·┌───────────────────┐·│   │·║
║·│  │·││·│                   │·│   │·║
║·│  │·└┘·└───────┐  ┌────────┘·└───┘·║
║·│  │············│  │················║
║·│  │·┌────────┐·│  │·┌────────────┐·║
║■│  │·│        │·│  │·│            │■║
║·└──┘·└────────┘·└──┘·└────────────┘·║
║·····································║
╚═════════════════════════════════════╝
╔════════════════╕──╒═════════════════╗
║················│  │·················║
║·┌───┐·┌──────┐·│  │·┌──┐·┌────────┐·║
║■└───┘·└──┐┌──┘·│  │·└──┘·└────────┘■║
║··········││····│  │·················║
╙───┐·┌──┐·││·┌──┘  └────┐·┌──┐·┌┐·┌┐·║
╓───┘·└─┐│·└┘·└──────────┘·└──┘·││·││·║
║·······││······················││·││·║
║·┌───┐·││·┌────┐ • ┌────┐·┌────┘│·││·║
║·│   │·││·│┌───┘   └───┐│·└─────┘·└┘·║
║·│   │·└┘·││           ││············║
║·│   │····││           ││·┌────────┐·║
║·│   │·┌┐·││           ││·│        │·║
║·│   │·││·││           ││·│        │·║
║·│   │·││·│└───────────┘│·│        │·║
║·└───┘·││·└─────────────┘·└────────┘·║
║·······││········ ···················║
╙───┐·┌─┘│·┌─────────────┐·┌┐·┌───┐·┌─╜
╓───┘·└──┘·└──────┐┌─────┘·││·└───┘·└─╖
║·················││·······││·········║
║■┌─────────────┐·││·┌─────┘└───────┐■║
║·└─────────────┘·└┘·└──────────────┘·║
║·····································║
╚═════════════════════════════════════╝
╔═════════════════╕─╒═════════════════╗
║·················│ │·················║
║■┌─┐·┌─┐·┌─────┐·│ │·┌─┐·╞════╦════╡■║
║·│ │·└─┘·└─┐ ┌─┘·│ │·│ │······║······║
║·│ │·······│ │···│ │·│ └────┐·║·┌──┐·║
║·└─┘·┌───┐·└─┘·┌─┘ │·│ ┌────┘·╨·└──┘·║
║·····│   │·····│   │·│ │·············║
╚═╡·┌─┘   │·┌─┐·└───┘·└─┘·┌─────────┐·║
« ··│     │·│ │···········│         │·║
╔═╡·└─┐ ┌─┘·│ │·╔══╗ ╔══╗·└─┐ ┌─────┘·║
║·····│ │···│ │·║ ╞╝ ╚╡ ║···│ │·······║
║·┌─┐·└─┘·╥·│ │·║       ║·╥·└─┘·╞═╦═╡·║
║·│ │·····║·│ │·║       ║·║·······║···║
║·│ │·┌──┐║·│ │·╚═══════╝·║╞══╗·╔╡║·╞═╝
║·│ │·│  │╨·└─┘····· ·····╚═══╣·║ ║·· »
║·└─┘·└──┘······┌─┐·┌┐·┌┐·····╨·╚═╝·╞═╗
║··········┌────┘ │·││·│└───┐·········║
║·╞═══╕──┐·└──────┘·││·└────┘·┌─┐·┌─┐·║
║·····│  │··········││········│ │·└┐│·║
║·┌─┐·└──┘·┌────────┘└──────┐·│ │··││·║
║·│ │······│                │·│ └┐·││·║
║■└─╘════╡·└────────────────┘·└──┘·└┘■║
║·····································║
╚═════════════════════════════════════╝
╔═════════════════╕─╒═════════════════╗
║·················│ │·················║
║·┌─┐·┌─────────┐·│ │·┌─────────────┐·║
║■│ │·└──┐ ┌────┘·│ │·│┌────────┐┌──┘■║
║·│ │····│ │······│ │·││········││····║
║·└─┘·┌┐·│ │·┌──┐·└─┘·└┘·┌────┐·││·╞╗·║
║·····││·└─┘·│  │········└─┐  │·││··║·║
╚═╡·┌─┘│·····│  │·┌────┐···│  │·│└┐·║·║
« ··│  └┐·┌┐·└──┘·│┌───┼─┐ └──┘·└─┘·║·║
╔═╡·└───┘·││······││···└─┘··········╨·║
║·········│└────┐·└┘·╥·····┌──────┐···║
║·╔═══╗·┌─┼───┐ │■···╙─────┘      └─┐·║
║·╚╡  ║·└─┘···└─┘·┌──┼─────────┐┌───┘·║
║·    ║·····╥·····└──┘·········└┘·····║
║·╔╡  ║·┌─┐·╙─┐·╥······┌───┐·╥····╥·╞═╝
║·╚═══╝·│ │·└─┘·╙──┐·┌─┘   │·╙─┐·┌╜·· »
║·······└─┘·····└──┘·└────┐│·│ │·││·╞═╗
║·┌┐·┌┐·····┌─┐···········└┘·└─┘·││···║
║·││·││·┌───┘ └───┐·╞══╕┐········└┘·╥·║
║·││·└┘·│┌───────┐│····└┘·┌─┐·┌┐····║·║
║■││····││·······││·┌┐····│ │·└╘════╝■║
║·└┘·╞╡·└┘·┌─┐·•·└┘·││·╞╡·└─┘·········║
║··········│ │······││········╔═══════╝
╚══════════╛─╘══════╛╘════════╝        
╔══════╗«  ╔═════╕─╒══════════════════╗
║··■···╚═╗·║·····│ │············■·····║
║·┌──┐···╨·╨·┌─┐·│ │·┌┐·╞╡·╞╡·┌──┐·┌┐·║
║·│  │·╥·····│ │·│ │·││·······│  │·└┘·║
║·│  │·╙─────┼─┘·└─┘·││·╞╡·╞╡·│  │····║
║·└──┘·└─────┘·······└┘·······└──┘·┌┐·║
║··············┌┐·┌┐····┌┐·┌┐······││·║
║·┌─┐·┌───╒════╛┘·└╘════╛┘·└┼─┐·┌──┘│·║
║·│ │·└──┐│·················╓─┘·└───┘·║
║·│ │····╓┘·╞═╕╒════╕─╒═══╡·╨····· ···║
║·│ │·┌┐·║····╓┘····└─┘·······┌──┐·┌──╜
║·└─┘·││·╨·┌┐·╨··┌┐·····┌───┐·└──┘·└──╖
║·····││···││···┌┘└┐·┌──┘   │·········║
║·┌───┘└─┐·│└─┐·└┐┌┘·└──┐   │·┌─────┐·║
║·│┌─────╖·│  │··└┘·····│┌──┘·└───┐ │·║
║·└┘·····╨·└──╘╡····┌─┐·││········│ │·║
║■···┌─┐·········╥·┌┘ │·││·┌────┐·│ │·║
║·┌┐·└─┘·╔═════╗·║·│  │·││·│    │·└─┘·║
║·││·····║     ║·║·│┌─┘·└┘·└──┐ │····■║
║·││·┌─┐·║  ■  ║·╨·└┘·········│ │·╞═╗·║
║·└┘·└─┘·║╥···╥║······┌─────┐·│ │· »║·║
║········╚╝·╥·╚╝·┌──┐·└─────┘·└─┘·╞═╝·║
╚══════╗····║····│  │·················║
       ╚════╩════╛──╘═════════════════╝
╔═════════════════╕╒══════════════════╗
║ ················└┘················· ║
║·┌───┐·┌───────┐····┌───┐·┌────────┐·║
║·│   │·└───────┘·┌┐·│   │·│        │·║
║·└───┘···········││·└───┘·└────────┘·║
║·······┌─┐·┌───┐·││··················║
║·┌─┐·╞═╡ │·└───┘·││·╥·┌┐·┌─┐·┌──┐·┌──╜
║·│ │···│ │·······││·║·││·│ │·│  │·└──╖
║·│ └─┐·│ │·┌┐·┌┐·││·║·││·└─┘·│  │····║
║·│   │·│ │·││·││·││·║·││·····│  └──┐·║
║·│ ┌─┘·└─┘·││·││·││·╨·││·╥·╥·│     │·║
║·│ │·······└┘·││·││···││·║·║·└─────┘·║
║·└─┘·┌──┐·····││·││·┌─┘│·║·║·········║
║·····│┌─┘·┌─┐·││·││·└──┘·║·╙─┐·┌───┐·║
║·┌─┐·││···│ │·└┘·││······╨·└─┘·└─┐┌┘·║
║·│ │·└┘·╥·│ │····││·┌──┐·········││··║
║·│ │····║·│ │·┌┐·││·│  └───────┐·││·╞╣
║·│ │·┌┐·╨·│ │·││·││·│┌────────┐│·││··║
║·│ │·││···│ │·└┘·││·└┘········└┘·│└┐·║
║·│ │·│└─┐·│ │····││····┌────┐····│ │·║
║·│ │·│  │·│ │·╞══╡╞══╡·│    └──┐·│ │·║
║·└─┘·└──┘·└─┘·· »││« ··└───────┘·└─┘·║
║ ·············╔══╛╘══╗·············· ║
╚══════════════╝      ╚═══════════════╝
╔═══════════╦═════════════╕──╒════════╗
║···········║·············│  │······· ║
║·╥·┌─╒═══╡·║·╞═╕─┐·┌───┐·└──┘·┌──┐·╞═╣
║·║·│ │·····║···│ │·└───╖······│  │···║
║·║·└─┘·┌─┐·╚═╡·│ │·····║·┌────┘  └─┐·║
║·║·····│ │·····│ │·┌─┐·║·│┌───────┐│·║
║·╙─┐·•·└─╖·┌─┐·│ │·│ │·║·└┘·······└┘·║
║·│ │·····║·╓─┘·└─┘·└─┘·║····┌───┐····║
║·└─┘·┌─┐·║·║«··········║·┌──┘   └──┐·║
║····■│ │·║·╚═╗·┌─────┐·║·└─────────┘·║
║·╞═══╛─┘·╨···║·└─────┘·╨·············║
║···········╥·║········ ··┌┐·┌┐·┌┐·┌┐·║
╠═══╡·╞═════╝·╨·┌─┐·┌─┐·┌─┘│·││·└┘·││·║
║···············│ │·│ │·│  │·││····││·║
║·┌─────────┐·┌─┘ │·│ │·│  │·││·┌┐·││·║
║·│         │·│   │·│ │·└──┘·││·││·└┘·║
║·└─────────┘·└───┘·│ │······││·││····║
║···················│ │·┌──┐■││·│└┐·┌─╜
║·┌────┐·┌┐·┌──┐·┌┐·│ │·└──┘·││·└─┘·│ │
║·└─┐  │·└┘·└──┘·││·│ │······││·····└─╖
║···│  │·····■···││·│ │·┌──┐·││·┌─┐· »║
╠═╡·└──┘·┌┐·╞══╡·└┘·│ │·└──┘·└┘·└─┘·╞═╣
║ ·······││·········│ │·············· ║
╚════════╛╘═════════╛─╘═══════════════╝
··╞═╡··································
╥·····╥·╥·┌───────────────────┐·╥·╥·╥·╥
║·╥·╥·║·║·╓───────────────────┘·║·║·║·║
║·║·║·║·║·║·····················║·║·║·║
║·║·║·║·║·║·╔══════╦╡·╔═╗·╔═╗·╥·║·║·╨·║
║·╨·╨·║·║·║·║······║··║·║·║·║·║·║·║···║
║·»·«·║·║·║·║·╞══╗·║·╞╝·╚═╝·╚═╝·║·╚═╗·║
║·╥·╥·║·║·║·║···■║·║············║···║·║
║·║·║·║·╨·║·╚════╝·║·┌────────┐·║·╔═╝·║
║·║·║·║···║········║·│┌──────┐│·║·║···║
║·║·║·╚═╡·╚════════╝·││······╓┘·╨·╚═╡·║
║·║·║················││·┌──┐·╨········║
║·║·║·╔╡·•·•·•·•·•·•·││·└──┘···╞══╗·╥·║
║·║·║·║··············││······╥····║·║·║
║·║·║·║·╞══════════╗·││·╥  ╥·╙╒═╗·║·║·║
║·║·║·║············║·││·║  ║·││·║·║·║·║
║·║·║·║·╔════════╗·║·└┘·╚══╝·└┘·║·║·║·║
║·║·║·║·║········║·║············╚═╝·╨·║
║·║·║·║·║■┌────┐·║·║·┌┐·╞══╡·┌┐·······║
║·║·║·║·╚═╛────┘·║·║·││······││·┌───┐·║
║·║·║·║··········║·║·│└──────┘│·│   │·║
║·╨·╨·╚══════════╝·╨·└────────┘·└───┘·║
║············ ·······················■║
╚═════════════════════════════════════╝
╔═════════════════════════════════════╗
║ ··································· ║
║·╔═══════════╡·╞═══════════════════╗·║
║·║·································║·║
║·║·╔═════════════════════════════╗·║·║
║·║·║·····························║·║·║
║·║·║·╔═══════════╡·╔═══════════╗·║·║·║
║·║·║·║·············║···········║·║·║·║
║·║·║·║·╔═══════════╝·╞═══════╗·║·║·║·║
║·║·║·║·║·····················║·║·║·║·║
║·║·║·║·║·┌──┐·┌──┐·┌──┐·┌──┐·║·║·║·║·║
║·║·║·║·║·│  │·│  │·│  │·│  │·║·║·║·║·║
║·║·║·║·║·└──┘·└──┘·└──┘·└──┘·║·║·║·║·║
║·║·║·║·║·····················║·║·║·║·║
║·║·╨·║·╚═════════════════════╝·║·║·║·║
║·║···║·························║·║·║·║
║·╚═╗·╚═════════════════╦═══════╝·║·║·║
║···║···················║·········║·║·║
║·╥·║╔══════════════════╝·╞═══════╣·║·║
║·║·╚╝····························╨·║·║
║·║····╔═════╗·╞════════════════╗···║·║
║·╚════╝····■║··················╚═══╝·║
║········╔═══╩════════════════╗····· ·║
╚════════╝                    ╚═══════╝
╔══════════════╕╒═════════════════════╗
║■·············││·····················║
╠═╡·┌────────┐·││·╥  ╥·┌┐·┌─────┐·╔═╡·║
║«··│        │·││·║  ║·││·└─────┘·║  ·║
║·•·└────────┘·││·╚══╝·││·········║  ·║
║··············││······│└────┐·┌┐·╚═╡·║
║·┌─────┐·┌──┐·││·┌──┐·└─────┘·││·····║
║·│     │·│  │·││·│  │·········│└───┐·║
║·│ ┌───┘·│  │·││·└──╘═══════╡·└────┘·║
║·│ │·····│  │·││············· ·······║
║·│ │·┌───┘  │·││·┌───┐·┌────┐·┌──┐·╥·║
║·│ │·│      │·││·│   │·│    │·│  │·║·║
║·│ │·└──────┘·└┘·╓───┘·└───┐│·│  │·║·║
║·└─┘·············║·········││·└──┘·║·║
║·····┌────┐·┌──┐·║·┌─────┐·││······║·║
║·┌─┐·│    │·│  │·║·└─────┘·││·╔════╝·║
║·│ │·└────┘·│  │·║·········││·║······║
║·│ │········│  │·║·╞═╕───┐·││·╚════╗·║
║·│ └──┐·╥·┌─┘  │·║···└───┘·││······║·║
║·└────┘·║·└────┘·╨·╥·······││·╔══╗·║·║
║········║·········»║·┌───┐·││·║  ║·║·║
║·╞══════╩══════════╝·└───┘·││·╨  ╨·╨·║
║···························││········║
╚═══════════════════════════╛╘════════╝
╔═╕╒══════════════════════════════════╗
║·││··································║
║·└┘·┌──────┐·╞═══╕─╒═══╡·┌─┐ ┌─┐·┌─┐·║
║····│      │·····│ │·····│ └─┘ │·│ │·║
║·┌┐·│  ┌───┘·┌─┐·│ │·┌─┐·│ ┌─┐ │·│ │·║
║·└┘·└┐ │«····│ │·└─┘·│ │·└─┘ └─┘·└┐│·║
║···· │ └┐·┌──┘ │·····│ │····╥·····││·║
║·┌┐·┌┘┌─┘·│    │·┌───┘ │·┌──╜·┌─┐·└┘·║
║·││·│ │···│ ┌──┘·└─────┘·└──┘·│ │····║
║·││·│ │·╥·└─┘·················│ │·┌┐·║
║·││·│ │·║·····┌┐ ┌─────┐·┌────┘ │·││·║
║·└┘·│ │·╙───┐·│└─┘     │·└───┐ ┌┘·││·║
║····│ │·│   │·│        │·····│ │··││·║
╙─┐·┌┘ │·└───┘·└────────┘·┌─┐·│ │·┌┘│·║
╓─┘·└┐ │··················│ │·└─┘·│ │·║
║····│ │·┌┐·┌────┐·┌┐·┌───┘ │·····│ │·║
║·┌┐·│ │·││·└────┘·││·│     │·┌─┐·│ │·║
║·││·│ │·││········││·└─────┘·│ │·└─┘·║
║·││·│ │·│╞═╡·╞╡·╞═╡│·········│ │·····║
║·││·│ │·││········││·┌─╒═╡·╞═╡ │·╔═╗·║
║·││·│ │·││·┌────┐·││·│ │ ···■│ │·║ ║·║
║·└┘·└┐│·└┘·└────┘·└┘·└─╘═╡·╞═╛─┘·╨ ╨·║
║····»││■·····························║
╚═════╛╘══════════════════════════════╝
       ╔══════════════════════════════╗
╔══════╝····························· ║
║········╔═╗·╞═════════════╡·┌──────┐·║
║ ╔════╡·║ ║·········╥ ╥·····│ ┌────┘·║
║·║ ╥····╨ ║·┌─────┐·╚═╝·┌─┐·│ │······║
║·╚═╝·╞════╝·└───┐ │·····│ │·│ │·┌┐·╥·║
║················│ │·┌─┐·│ │·└─┘·││·║·║
╠══════════════╗·└─┘·│ │·│ │·····││·║·║
║ ·············║·····│ │·│ │·╔═╡·└┘·║·║
║·╔══════════╗·║·┌─┐·│ │·│ │·║╥·····║·║
║·║··········║·║·│ │·└─┘·│ │·║║·╔══╡║·║
║·║·╔══════╗·║·║·│ │·····│ │·╚╝·║╞══╝·║
║·║·║······║·║·║·│ │·┌───┘ │«···║·····║
║·║·║·╔══╡■║·║·║·└─┘·│     │·╔═╡║·┌─┐·║
║·║·║·║····║·║·║·····│ ┌───┘·╚══╝·│ │·║
║·║·║·║·»╞═╝·║·║·╥·╥·│ │··········│ │·║
║·║·║·║······║·║·║·║·└─┘·┌─┐·┌────┘ │·║
║·║·║·╚══════╝·║·║·║·····│ │·└────┐ │·║
║·║·║··········║·║·║·┌─┐·│ │······│ │·║
║·║·╚══════════╝·║·║·└─┘·│ │·╔══╗·└─┘·║
║·║··············║·║·····│ │·║╞═╝·····║
║·╚══════════════╝·║·┌─┐·└─┘·╚═════╡ ╔╝
║··················║·│ │·············║ 
╚══════════════════╩═╛─╘═════════════╝ 
╔═══════════╦════════════╦════════════╗
║·········· ║··········· ║ ···········║
║·╔══╦═══╗·╥║·┌────┐·╔╗·╥║╥·╔═╗ ╞╗·╔╗·║
║·╚╡ ╚╗ ╞╝·╚╝·│┌─┐ │·║║·╠╩╣·║ ╚══╝·╨║·║
║···· ║·······└┘ └┐│·║╨·╨ ╨·╚╗····· ║·║
║·╔╗·╥║·┌┐·┌┐···· ││·║«····· ║·╔═╡·╞╝·║
║·║║·║║·││·││ ┌┐·┌┘│·║╞═╗·┌─┐║·║ ·····║
║·║╨·╚╝·└╖·└╘═╛┘·└─┘·╚══╝·└─┘║·╚╗·╔═╗·║
║·║ ···· ║·················· ║··║·╨ ║·║
║·║╥ ┌┐ ┌╜·┌─┐·╥ ╔═╗·╔══╗ ╥·┌╨┐·║···║·║
║·╚╩═╛╘═╛┘·└┐│·║╞╝ ║·║··╚╦╝·└─┘·╚═╡·╨·║
║·········· ││·╚═══╝·╚╗· ║ ····· • ···║
║·┌──┐·┌─┐ ┌┘│······· ║·╞╩╗·┌─┐·┌──┐·┌╜
║·└──╖·│ └─┘ │ ╔╗·╔╡ •║···╨·╓─┘·└─┐│·└╖
║··· ║·│ ┌─┐ │•║╨·╚═══╬═╗···║···· ││· ║
║·╥·╔╝·└─┘ └─┘ ║ ···· ║ ╨·╞═╣·╔╗·┌┘│·┌╜
║·║·║ ·········║╥·┌┐·╔╝···· ║·║╨·└─┘·└╖
║·╨·╚╗ ╔═╗·╞═╗·╚╝·└┘·║··╞╗·╥║·║ ······║
║····╚═╝ ║··»║·······║·╔═╝·╚╝·╚╗·┌──┐·║
║·┌┐·····║╥·╥║ ┌┐ ╥·╔╝·╚╗ ···· ║·│  │·║
║·││ ┌─┐·╚╝·╚╩═╛╘═╝·║ ··║╥·╔══╗║·╓─┐│·║
║·└╘═╛─┘············╚═╡·╚╝·╚╡ ╚╝·╨ └┘·║
║········┌┐ ╞══╡ ┌┐···················║
╚════════╛╘══════╛╘═══════════════════╝
