1 30x31 RGHOST=15.5 RTOP=12 RHERO=20.5 CMSG=10 CMSG2=10 ABOUT="Inspired by NBGI/Namco's 'Pac-Man vs.' Vodaphone live! game"
╔══════════╗      ╔══════════╗
║··········║      ║··········║
║·┌┐·┌┐·┌┐·║      ║·┌┐·┌┐·┌┐·║
║·└┘·││·└┘·║      ║·└┘·││·└┘·║
║···■││····╚══════╝····││■···║
║·┌──┘└──┐··········┌──┘└──┐·║
║·└──┐┌──┘·┌┐ ┌┐ ┌┐·└──┐┌──┘·║
║····││····└┘ └┘ └┘····││····║
║·┌┐·││·┌┐          ┌┐·││·┌┐·║
║·└┘·└┘·││ ┌──────┐ ││·└┘·└┘·║
║·······││ └──────┘ ││·······║
║ ┌──┐·┌┘│          │└┐·┌──┐ ║
║ │  │·│ │ ╔══≡≡══╗ │ │·│  │ ║
╝ │  │·└─┘ ║      ║ └─┘·│  │ ╚
  │  │·    ║      ║    ·│  │  
╗ │  │·┌─┐ ║      ║ ┌─┐·│  │ ╔
║ │  │·│ │ ╚══════╝ │ │·│  │ ║
║ │  │·│ │          │ │·│  │ ║
║ │  │·│ │ ┌──────┐ │ │·│  │ ║
║ └──┘·└┐│ └──────┘ │┌┘·└──┘ ║
║·······││          ││·······║
║·┌┐·┌┐·││·┌┐ ┌┐ ┌┐·││·┌┐·┌┐·║
║·└┘·││·└┘·││ ││ ││·└┘·││·└┘·║
║····││····││ ││ ││····││····║
║·┌──┘└──┐·└┘ └┘ └┘·┌──┘└──┐·║
║·└──┐┌──┘··········└──┐┌──┘·║
║···■││····╔══════╗····││■···║
║·┌┐·││·┌┐·║      ║·┌┐·││·┌┐·║
║·└┘·└┘·└┘·║      ║·└┘·└┘·└┘·║
║··········║      ║··········║
╚══════════╝      ╚══════════╝
