1 27x23 READY="READY!!" GAMEOVER="THE END" PLAYER1="PLAYER1" PLAYER2="PLAYER2" RGHOST=11.5 ROGHOST=1.5 RTOP=8.5 RHERO=17.5 RMSG=11 CMSG=0 CMSG2=20 ABOUT="Inspired by an unofficial ZX Spectrum Pac-Man clone"
╔════════════╦════════════╗
║············║············║
║·╔═╗·╔═╦══╡·╨·╞══╦═╗·╔═╗·║
║■║ ║·║ ║·········║ ║·║ ║■║
║·╚═╝·╚═╝·╞══╦══╡·╚═╝·╚═╝·║
║············║············║
║·╔═╗·╔════╗·║·╔════╗·╔═╗·║
║·╚═╝·╚═╦══╝·╨·╚══╦═╝·╚═╝·║
║·······║·········║·······║
╚═════╗·║·╔═≡≡≡═╗·║·╔═════╝
══════╝·╨·║     ║·╨·╚══════
       ···║     ║···       
══════╗·╥·║     ║·╥·╔══════
╔═════╝·╨·╚══╦══╝·╨·╚═════╗
║············║············║
║·╔═╗·╔════╗·║·╔════╗·╔═╗·║
║■╚═╣·╚════╝·╨·╚════╝·╠═╝■║
║···║········ ········║···║
╠═╡·╚═╡·╥·╞══╦══╡·╥·╞═╝·╞═╣
║·······║····║····║·······║
║·╞═════╩══╡·╨·╞══╩═════╡·║
║·························║
╚═════════════════════════╝
