1 31x22 READY="  READY!!  " GAMEOVER=" GAME OVER " PLAYER1="PLAYER  ONE" PLAYER2="PLAYER  TWO" RGHOST=10.5 ROGHOST=1 RFRUIT=12.5 RTOP=8.5 RHERO=16.5 RMSG=12 CMSG=10 RMSG2=8 CMSG2=10 ABOUT="Inspired by Atarisoft's ZX Spectrum Pac-Man conversion"
╔══════════════╦══════════════╗
║··············║··············║
║·╔══╗·╔═════╗·║·╔═════╗·╔══╗·║
║■╚══╝·╚═════╝·╨·╚═════╝·╚══╝■║
║·····························║
║·╞══╡·╔╗·╞════╦════╡·╔╗·╞══╡·║
║······║║······║······║║······║
╚════╗·║╠════╡ ╨ ╞════╣║·╔════╝
     ║·║║             ║║·║     
═════╝·╚╝ ╔═══≡≡≡═══╗ ╚╝·╚═════
      ·   ║         ║   ·      
═════╗·╔╗ ╚═════════╝ ╔╗·╔═════
     ║·║║             ║║·║     
╔════╝·╚╝ ╞════╦════╡ ╚╝·╚════╗
║··············║··············║
║·╞══╗·╞═════╡·╨·╞═════╡·╔══╡·║
║■···║········· ·········║···■║
╠══╡·╨·╔╗·╞════╦════╡·╔╗·╨·╞══╣
║······║║······║······║║······║
║·╞════╩╩════╡·╨·╞════╩╩════╡·║
║·····························║
╚═════════════════════════════╝
