1 32x27 \
   RTOP=11.5 \
 RGHOST=14.5  CGHOST=16 \
 ROGHOST=2   COGHOST=2  \
  RFRUIT=10.5 CFRUIT=16 \
   RHERO=19.5  CHERO=16 \
    RMSG=10     CMSG=11 \
   RMSG2=10    CMSG2=11 \
   ABOUT="Inspired by 'Pâques' for the Acorn Archimedes/RISC PC"
╔══════════════╕╒══════════════╗
║··············││··············║
║·┌──┐·┌─────┐·││·┌─────┐·┌──┐·║
║■│  │·│  ┌──┘·└┘·└──┐  │·│  │■║
║·│  │·│  │··········│  │·│  │·║
║·│  │·│  │·┌──────┐·│  │·│  │·║
║·└──┘·└──┘·└──┐┌──┘·└──┘·└──┘·║
║··············││··············║
║·┌──┐·┌─────┐·││·┌─────┐·┌──┐·║
║·└──┘·└─┐┌──┘·└┘·└──┐┌─┘·└──┘·║
║········││          ││········║
╚══════╗·││ ╔══≡≡══╗ ││·╔══════╝
═══════╝·└┘ ║      ║ └┘·╚═══════
        ·   ║      ║   ·        
═══════╗·┌┐ ║      ║ ┌┐·╔═══════
╔══════╝·└┘ ╚══╕╒══╝ └┘·╚══════╗
║··············││··············║
║·┌──┐·┌─────┐·││·┌─────┐·┌──┐·║
║■└─┐│·└─────┘·└┘·└─────┘·│┌─┘■║
║···││·········  ·········││···║
╙─┐·│└─┐·┌┐·┌──────┐·┌┐·┌─┘│·┌─╜
╓─┘·└──┘·││·└──┐┌──┘·││·└──┘·└─╖
║········││····││····││········║
║·┌──────┘└──┐·││·┌──┘└──────┐·║
║·└──────────┘·└┘·└──────────┘·║
║······························║
╚══════════════════════════════╝
