4 30x22 RHERO=18.5 CHERO=14.5 RFRUIT=18.5 CFRUIT=14.5 RGHOST=4.5 CGHOST=14.5 ROGHOST=0 COGHOST=0 RTOP=4.5 RMSG=0 CMSG=18 RMSG2=0 CMSG2=2 DOT_COLORS="\x09" PELLET_COLORS="\x02" WALL_COLORS="\x06\x05\x0D\x03" MORTAR_COLORS="\x0C" ABOUT="Inspired by Exidy's 'Pepper II' (Colecovision version)"
╔═══════════╗║ ║╔════════════╗
║···········║║ ║║············║
║■┌┐·┌─┐·┌┐·║║ ║║·┌────────┐■║
║·││·└─┘·││·╚╝ ╚╝·└────────┘·║
║·││·····││··················║
║·│└───┐·│└──┐·┌┐·┌────┐·┌─┐·║
║·└────┘·└───┘·└┘·│    │·└─┘·║
║·················│    │·····║
╚═══╗·┌┐·┌┐·┌───┐·│    │·╔═══╝
════╝·└┘·││·│   │·│ ┌──┘·╚════
     ····││·│   │·│ │····     
════╗·┌┐·││·│   │·│ │·┌┐·╔════
    ║·││·││·│   │·│ │·││·║    
╔═══╝·└┘·└┘·└───┘·└─┘·││·╚═══╗
║·····················││·····║
║·┌─┐·┌┐·┌┐·┌┐·┌────┐·││·┌─┐·║
║·│ │·└┘·││·││·│    │·└┘·│ │·║
║·│ │■···││·└┘·└──┐ │···■│ │·║
║·│ │·┌┐·││·······│ │·┌──┘ │·║
║·└─┘·└┘·└┘·╔╗ ╔╗·└─┘·└────┘·║
║···········║║ ║║············║
╚═══════════╝║ ║╚════════════╝
╔═══════════╗║ ║╔════════════╗
║···········║║ ║║············║
║■┌─┐·┌┐·┌┐·║║ ║║·┌────┐·┌─┐■║
║·└─┘·││·││·╚╝ ╚╝·│    │·└─┘·║
║·····││·││·······│    │·····║
║·┌─┐·││·││·┌┐·┌┐·│    │·┌─┐·║
║·└─┘·└┘·└┘·└┘·└┘·└────┘·└─┘·║
║····························║
╚═══╗·┌───┐·┌───┐·┌────┐·╔═══╝
════╝·└───┘·│   │·└────┘·╚════
     ·······│   │········     
════╗·┌───┐·│   │·┌────┐·╔════
╔═══╝·└───┘·└───┘·└────┘·╚═══╗
║····························║
║·┌─┐·┌───┐·┌┐·┌┐·┌────┐·┌─┐·║
║·│ │·│   │·││·││·│ ┌──┘·│ │·║
║·│ │·│   │·││·││·│ │····│ │·║
║·│ │■└───┘·└┘·└┘·└─┘·┌┐■└─┘·║
║·│ │·················││·····║
║·└─┘·╞═══╡·╔╗ ╔╗·╞═══╛╘═══╡·║
║···········║║ ║║············║
╚═══════════╝║ ║╚════════════╝
╔═══════════╗║ ║╔════════════╗
║···········║║ ║║············║
║■┌───────┐·║║ ║║·┌────────┐■║
║·│ ┌─────┘·╚╝ ╚╝·└──────┐ │·║
║·│ │····················│ │·║
║·│ │·┌─┐·┌──┐·┌────┐·┌┐·│ │·║
║·└─┘·╓─┘·└──┘·└────┘·││·└─┘·║
║·····║···············││·····║
╚═══╗·║·┌────┐·┌┐·┌─┐·││·╔═══╝
════╝·╨·│┌───┘·└┘·│ │·└┘·╚════
     ···││····■···│ │····     
════╗·╥·││·┌────┐·│ │·┌┐·╔════
╔═══╝·║·└┘·└────┘·└─┘·││·╚═══╗
║·····║···············││·····║
║·┌─┐·║·╞════╡·╞════╡·││·┌─┐·║
║·│ │·║···············││·│ │·║
║·│ │·╙─┐·┌──┐·┌────┐·││·│ │·║
║·│ │■└─┘·└──┘·└────┘·└┘■│ │·║
║·│ │····················│ │·║
║·└─╘═════╡·╔╗ ╔╗·╞══════╛─┘·║
║···········║║ ║║············║
╚═══════════╝║ ║╚════════════╝
    ╔═══════╗║ ║╔════════════╗
    ║·······║║ ║║············║
╔═══╝·┌───┐·║║ ║║·┌────╒═══╡■║
║·····│┌──┘·╚╝ ╚╝·│    │·····║
║■┌─┐·││··········└────┘·╞═══╣
║·│ │·└┘·╞═══╡·┌┐············║
║·└─┘··········││·┌────╒═══╡·║
║·····┌╒══╡·╞══╛┘·└───┐│·····║
╚═══╗·││··············││·╔═══╝
════╝·││·┌┐·┌───┐·┌─┐·││·╚════
     ·││·││·│   │·│ │·││·     
════╗·││·││·│   │·│ │·││·╔════
╔═══╝·└┘·││·└───┘·│ │·││·╚═══╗
║········││·······│ │·││·····║
║·┌─┐·┌┐·│└──┐·┌──┘ │·││·┌─┐·║
║·└─┘·││·└───┘·└────┘·└┘■│ │·║
║·····││·················│ │·║
║·┌─┐■└╘══╡·╞╡·╔╗·┌─┐·┌╒═╛─┘·║
║·│ │··········║║·│ │·││·····║
║·└─╘═════╡·╔╗ ║║·└─┘·└┘·╔═══╝
║···········║║ ║║········║    
╚═══════════╝║ ║╚════════╝    
