1 19x22 READY="READY!!" GAMEOVER="GOODBYE" PLAYER1="PLAYER1" PLAYER2="PLAYER2" RGHOST=10.5 ROGHOST=1 COGHOST=1 RFRUIT=12.5 RTOP=8.5 RHERO=16.5 RMSG=12 CMSG=6 RMSG2=8 CMSG2=6 ABOUT="Inspired by K. Moriyama's 'P-MAN' DHTML game"
╔════════╦════════╗
║········║········║
║·┌┐·┌─┐·║·┌─┐·┌┐·║
║■└┘·└─┘·╨·└─┘·└┘■║
║·················║
║·╞╡·╥·╞═╦═╡·╥·╞╡·║
║····║···║···║····║
╚══╗·╠═╡ ╨ ╞═╣·╔══╝
   ║·║       ║·║   
═══╝·╨ ╔═≡═╗ ╨·╚═══
    ·  ║   ║  ·    
═══╗·╥ ╚═══╝ ╥·╔═══
   ║·║       ║·║   
╔══╝·╨ ╞═╦═╡ ╨·╚══╗
║········║········║
║·╞╗·╞═╡·╨·╞═╡·╔╡·║
║■·║···········║·■║
╠╡·╨·╥·╞═╦═╡·╥·╨·╞╣
║····║···║···║····║
║·╞══╩═╡·╨·╞═╩══╡·║
║·················║
╚═════════════════╝
