2 30x28 READY=" READY! " GAMEOVER="ALL GONE" PLAYER1="PLAYER 1" PLAYER2="PLAYER 2" RGHOST=15.5 RTOP=12 RHERO=20.5,26.5 CMSG=11 CMSG2=11 ABOUT="Inspired by Genie's 'Puckman Pockimon' arcade game" FIXME="the upper-left and lower-right blank zones should be warp tunnels"
╔════════════════════════════╗
║■··························■║
║·┌───┐·┌───┐·┌┐·┌───┐·┌───┐·║
║·└───┘ └───┘·└┘·└───┘·└───┘·║
║·····   ····················║
║·┌─────┐·┌────────┐·┌─────┐·║
║·│     │·│        │·│     │·║
║·└─────┘·└────────┘·└─────┘·║
║····························║
║·┌─────────┐ ┌┐ ┌─────────┐·║
║·└─────────┘ └┘ └─────────┘·║
║··········        ··········║
╚══╗·┌┐·┌┐·╔══≡≡══╗·┌┐·┌┐·╔══╝
   ║·││·││·║      ║·││·││·║   
   ║·││·└┘·║      ║·└┘·││·║   
╔══╝·││····║      ║····││·╚══╗
║····│└──┐·╚══════╝·┌──┘│····║
║·┌──┘   │·        ·│   └──┐·║
║·│      │·┌──────┐·│      │·║
║·│┌─────┘·└──────┘·└─────┐│·║
║·││··········  ··········││·║
║·└┘·┌┐·┌┐·┌──────┐·┌┐·┌┐·└┘·║
║···■││·└┘·└──┐┌──┘ └┘·││■···║
║·┌┐·││·······││··   ··││·┌┐·║
║·││·││·┌┐·┌┐·││·┌┐ ┌┐·││·││·║
║·└┘·└┘·││·└┘·└┘·└┘·││·└┘·└┘·║
║·······││··········││·······║
╚═══════╛╘══════════╛╘═══════╝
╔════════════════════════════╗
║····························║
║·┌────┐·┌──────────┐·┌────┐·║
║·└────┘·│          │·└────┘·║
║·······■│          │■·······║
╚══╗·┌───┘          └───┐·╔══╝
═══╝·└──────────────────┘·╚═══
    ······················    
═══╗·┌───┐ ┌──────┐ ┌───┐·╔═══
   ║·│   │ │      │ │   │·║   
╔══╝·└───┘ └──────┘ └───┘·╚══╗
║·······              ·······║
║·┌───┐·┌┐ ╔══≡≡══╗ ┌┐·┌───┐·║
║·│   │·││ ║      ║ ││·│   │·║
║·│   │·││ ║      ║ ││·│   │·║
║·│   │·││ ║      ║ ││·│   │·║
║·└───┘·└┘ ╚══════╝ └┘·└───┘·║
║····························║
║·┌───┐·┌┐·┌──────┐·┌┐·┌───┐·║
║·│   │·││·│      │·││·│   │·║
║·│   │·││·│      │·││·│   │·║
║·│   │·││·│      │·││·│   │·║
║·└───┘·└┘·└──────┘·└┘·└───┘·║
║■··························■║
╚═╗·┌────┐·┌──────┐·┌────┐·╔═╝
══╝·└────┘·└──────┘·└────┘·╚══
                              
══════════════════════════════
