1 30x33 READY="  READY!  " GAMEOVER="GAME  OVER" PLAYER1="PLAYER ONE" PLAYER2="PLAYER TWO" RFRUIT=18.5 RHERO=21.5 RMSG=18 CMSG=10 CMSG2=10 ABOUT="Inspired by YumPop.com's 'Quackman'"
╔════╕╒═══════╕╒═════════════╗
║····││·······││·············║
║·┌┐·││·┌┐·┌┐·││·┌┐·┌──────┐·║
║■││·││·││·││·││·││·│┌─┐┌─┐│■║
║·││·└┘·││·││·││·││·││·ll·││·║
║·││····││·││·││·││·││·││·││·║
║·│└────┘│·││·││·││·││·││·││·║
║·└──┐┌──┘·││·└┘·││·││·││·││·║
║····││····││····││·││·││·││·║
╚══╗·││·┌┐ │└────┘│·││·││·││·║
   ║·└┘·││ └──────┘·└┘·└┘·└┘·║
   ║····││            ·······║
   ║·┌┐·││ ╔══≡≡══╗ ┌┐·┌┐·╔══╝
   ║·││·││ ║      ║ ││·││·║   
═══╝·└┘·└┘ ║      ║ └┘·└┘·╚═══
    ····   ║      ║   ····    
═══╗·┌┐·┌┐ ║      ║ ┌┐·┌┐·╔═══
   ║·││·││ ╚══════╝ ││·││·║   
   ║·││·││          ││·││·║   
   ║·││·││ ┌──────┐ ││·││·║   
╔══╝·└┘·└┘ └──────┘ └┘·└┘·╚══╗
║············  ··············║
║·┌──────┐·┌──────┐·┌──────┐·║
║·│┌────┐│·│┌────┐│·│┌────┐│·║
║·││    ││·││    ││·││    ││·║
║·││    ││·││    ││·││    ││·║
║·│└────┘│·││    ││·│└────┘│·║
║·│┌─────┘·││    ││·│┌─────┘·║
║■││·······││    ││·││······■║
║·││·┌───┐·│└────┘│·││·┌───┐·║
║·└┘·└───┘·└──────┘·└┘·└───┘·║
║····························║
╚════════════════════════════╝
