1 32x23 RHERO=14.5 RFRUIT=14.5 RGHOST=11.5 COGHOST=1 ROGHOST=3 RTOP=11.5 RMSG=8 RMSG2=14 CMSG=11 CMSG2=11 WALL_COLORS="\x09" MORTAR_COLORS="\x09" DOT_COLORS="\x0E" ABOUT="Inspired by Micromania's 'Ghost's Revenge'"
┌──────────────────────────────┐
│┌─────────────┐┌─────────────┐│
││■ ···········││··········· ■││
││ ┌───┐·┌───┐·││·┌───┐·┌───┐ ││
││·└───┘·└──┐│·└┘·│┌──┘·└───┘·││
││··········││····││··········││
│└──┐·┌───┐·││·┌┐·││·┌───┐·┌──┘│
│┌──┘·└───┘·└┘·└┘·└┘·└───┘·└──┐│
││··········        ··········││
┘│·┌────┐·┌────~~────┐·┌────┐·│└
─┘·└────┘·│┌───~~───┐│·└────┘·└─
     ·····││        ││·····     
─┐ ┌────┐·│└────────┘│·┌────┐ ┌─
┐│·│┌───┘·└──────────┘·└───┐│·│┌
││·││·····            ·····││·││
││·││·┌─┐·┌──────────┐·┌─┐·││·││
││·└┘·└─┘·└────┐┌────┘·└─┘·└┘·││
││·············││·············││
││·┌┐·┌┐·┌───┐·││·┌───┐·┌┐·┌┐·││
││ └┘·││ └───┘·└┘·└───┘ ││·└┘ ││
││■ ··││················││·· ■││
│└────┘└────────────────┘└────┘│
└──────────────────────────────┘
