1 28x31 ABOUT="Inspired by Kaniya's 'Scandal Man', an early hack of the original Puckman"
╔════════════╕╒════════════╗
║············││············║
║·┌──┐·┌───┐·││·┌───┐·┌──┐·║
╝■│  │·│   │·└┘·│   │·│  │■╚
 ·└──┘·└───┘····└───┘·└──┘· 
╗············┌┐············╔
║·┌──┐·┌┐·┌──┘└──┐·┌┐·┌──┐·║
║·└──┘·││·└──┐┌──┘·││·└──┘·║
║······││····││····││······║
╚╗ ╔═╗·│└──┐ ││ ┌──┘│·╔═╗ ╔╝
 ║ ║ ║·│┌──┘ └┘ └──┐│·║ ║ ║ 
 ║ ║ ║·└┘          └┘·║ ║ ║ 
 ║ ║ ║·   ╔══≡≡══╗   ·║ ║ ║ 
═╝ ╚═╝·┌┐ ║      ║ ┌┐·╚═╝ ╚═
 ·    ·││ ║      ║ ││·    · 
═╗ ╔═╗·└┘ ║      ║ └┘·╔═╗ ╔═
 ║ ║ ║·   ╚══════╝   ·║ ║ ║ 
 ║ ║ ║·┌┐          ┌┐·║ ║ ║ 
 ║ ║ ║·││ ┌──────┐ ││·║ ║ ║ 
╔╝ ╚═╝·└┘ └──┐┌──┘ └┘·╚═╝ ╚╗
║············││············║
║·┌──┐·┌───┐·││·┌───┐·┌──┐·║
║·└─┐│·└───┘·└┘·└───┘·│┌─┘·║
║■··││·······  ·······││··■║
╙─┐·││·┌┐·┌──────┐·┌┐·││·┌─╜
──┘·└┘·││·└──┐┌──┘·││·└┘·└──
 ···· ·││····││····││· ···· 
╗·┌─┐·┌┘└──┐·└┘·┌──┘└┐·┌─┐·╔
║·└─┘ └────┘····└────┘ └─┘·║
║············╔╗············║
╚════════════╝╚════════════╝
