1 33x24 READY="  READY!!  " GAMEOVER=" GAME OVER " PLAYER1="PLAYER ONE " PLAYER2="PLAYER TWO " RGHOST=6.5 ROGHOST=0 COGHOST=1.5 RFRUIT=6.5 RTOP=3 RHERO=21.5 RMSG=23 CMSG=11 RMSG2=0 CMSG2=11 ABOUT="Inspired by 'Scarfman' for the TRS-80"
┌───────────────╥───────────────┐
│┌─────────────┐║┌─────────────┐│
││·············│║│·············││
││·┌┐·┌───┐·┌┐ │║│ ┌┐·┌───┐·┌┐·││
││·││·└───┘·││ │║│ ││·└───┘·││·││
││■││·······││ └╨┘ ││·······││■││
││ │└──┐·┌┐·││     ││·┌┐·┌──┘│ ││
││·│╞═╡│·││·│└─────┘│·││·│╞═╡│·││
││·└───┘·││·└───────┘·││·└───┘·││
││·······││···········││·······││
┘└─────┐·││·┌──┐■┌──┐·││·┌─────┘└
───────┘·└┘·│┌─┘ └─┐│·└┘·└───────
 ···········││·····││··········· 
─┐·┌───┐·┌┐·││·┌─┐·││·┌┐·┌───┐·┌─
┐│·└──┐│·││·└┘·│╥│·└┘·││·│┌──┘·│┌
││····││·││····│║│····││·││····││
│└──┐·││·││·┌──┘║└──┐·││·││·┌──┘│
│┌──┘·└┘·││·└──┐║┌──┘·││·└┘·└──┐│
││·······││····│║│····││·······││
││■┌───┐·│└──┐·│╨│·┌──┘│·┌───┐■││
││ └───┘·└───┘·└─┘·└───┘·└───┘ ││
││·············· ··············││
│└─────────────────────────────┘│
└───────────────────────────────┘
