4 19x21 READY=" READY!" GAMEOVER=" GONE  " PLAYER1=" P ONE " PLAYER2=" P TWO " RGHOST=9.5 ROGHOST=1 COGHOST=1 RFRUIT=11.5 RTOP=8 RHERO=15.5 RMSG=11 CMSG=6 RMSG2=7 CMSG2=6 WALL_COLORS="\x00\x07\x03\x0E" MORTAR_COLORS="\x09\x0C\x0F\x04" DOT_COLORS="\x07\x0F\x0E\x0C" ABOUT="Inspired by the 'PacMan' game for SymbOS by Prodatron"
╔════════╦════════╗
║········║········║
║■╞╡·╞═╡·╨·╞═╡·╞╡■║
║·················║
║·╞╡·╥·╞═╦═╡·╥·╞╡·║
║····║···║···║····║
╚══╗·╠═╡ ╨ ╞═╣·╔══╝
   ║·║       ║·║   
═══╝·╨ ╔═≡═╗ ╨·╚═══
    ·  ║   ║  ·    
═══╗·╥ ╚═══╝ ╥·╔═══
   ║·║       ║·║   
╔══╝·╨ ╞═╦═╡ ╨·╚══╗
║········║········║
║·╞╗·╞═╡·╨·╞═╡·╔╡·║
║■·║····· ·····║·■║
╠╡·╨·╥·╞═╦═╡·╥·╨·╞╣
║····║···║···║····║
║·╞══╩═╡·╨·╞═╩══╡·║
║·················║
╚═════════════════╝
╔════╦═══════╦════╗
║····║·······║····║
║■╞╡·╨·╞═══╡·╨·╞╡■║
║·················║
╩╡·╥·╞═╡·╥·╞═╡·╥·╞╩
  ·║·····║·····║·  
═╗·╚═╡ ╞═╩═╡ ╞═╝·╔═
 ║·             ·║ 
 ║·╔═╡ ╔═≡═╗ ╞═╗·║ 
 ║·║   ║   ║   ║·║ 
═╝·╨ ╥ ╚═══╝ ╥ ╨·╚═
  ·  ║       ║  ·  
═╗·╞═╩═╡ ╥ ╞═╩═╡·╔═
 ║·····  ║  ·····║ 
╔╝·╞═╡·╞═╩═╡·╞═╡·╚╗
║········ ········║
║·┌┐·╔═╡·╥·╞═╗·┌┐·║
║·││·║···║···║·││·║
║■└┘·╨·╞═╩═╡·╨·└┘■║
║·················║
╚═════════════════╝
═════╦═══════╦═════
     ║·······║     
╦══╡ ╨·╞═╦═╡·╨ ╞══╦
║■·······║·······■║
║·╔══╡·╥·╨·╥·╞══╗·║
║·║····║···║····║·║
║·╨·╞╗ ╚═══╝ ╔╡·╨·║
║····║       ║····║
╠══╡·║ ╔═≡═╗ ║·╞══╣
║····╨ ║   ║ ╨····║
║·╞╗·  ╚═══╝  ·╔╡·║
║··║·╥       ╥·║··║
╚╗·╨·╚╡·┌─┐·╞╝·╨·╔╝
 ║······│ │······║ 
═╝·╞═╦╡·└─┘·╞╦═╡·╚═
  ···║··   ··║···  
╦╡·╥·╨·╞═╦═╡·╨·╥·╞╦
║■·║·····║·····║·■║
║·╞╝·╞═╡·╨·╞═╡·╚╡·║
║·················║
╚═════════════════╝
╔═══════╝ ╚═══════╗
║·················║
║·╥■╞═══════════╗·║
╝·║·············║·╚
 ·╠═══════════╡·║· 
╗·║·············║·╔
║·╨■╞═══════════╝·║
║·····       ·····║
║·╥·╞╗ ╔═≡═╗ ╔╡·╥·║
║·║··║ ║   ║ ║··║·║
╝·╨·╞╝ ╚═══╝ ╚╡·╨·╚
 ·····       ····· 
╗·╥■╔═══╗·╔═══╗■╥·╔
║·║·║···║·║···║·║·║
║·║·║·╥·║·║·╥·║·║·║
║·║·║·║·║ ║·║·║·║·║
║·║·╨·║·║·║·║·╨·║·║
║·║···║·║·║·║···║·║
╝·╚═══╝■╨·╨■╚═══╝·╚
 ················· 
════════╗ ╔════════
