9 31x28 RHERO=13.5 CHERO=8.5 RGHOST=1.5,13.5,1.5,17.5,4.5,4.5,4.5,4.5,4.5 CGHOST=15.5,15.5,15.5,15.5,15.5,15.5,15.5,15.5,15.5 ROGHOST=-12,12,-25,8,-16,-16,-16,-16,-16 COGHOST=11,13,11,4,6,6,6,6,6 RTOP=1.5,1.5,1.5,9.5,4.5,4.5,4.5,4.5,4.5 RFRUIT=13.5 CFRUIT=8.5 DOT_COLORS="\x02" PELLET_COLORS="\x0E" WALL_COLORS="\x0E\x0B\x09\x03\x0C\x01\x0D\x0E\x09" MORTAR_COLORS="\x04\x03\x01\x03\x0C\x01\x05\x04\x01" RMSG=27 CMSG=11 RMSG2=0 CMSG2=11 READY=" READY!! " PLAYER1=" PLAYER 1" PLAYER2=" PLAYER 2" GAMEOVER="GAME OVER" ABOUT="Inspired by Philip Lieberman/Pacific Novelty Manufacturing, Inc.'s 'Thief'"
 ┌─╒═══════════════════════╕─┐ 
 │ │■·····················■│ │ 
 │ │·┌────────┐·┌────────┐·│ │ 
 │ │·│┌─────┐ │·│ ┌────┐ │·│ │ 
 │ │·││·····│ │·│ │····│ │·│ │ 
 │ │·││·┌─┐·└─┘·└─┘·┌┐·└─┘·│ │ 
 │ │·││·│ │·········││·····│ │ 
 │ │·││·│ └─┐·┌─┐·┌─┘│·┌─┐·│ │ 
 ╓─┘·└┘·└───┘·└─┘·└──┘·└─┘·└─╖ 
 ║···························║ 
 ║·┌──┐·┌─────┐·┌────┐·┌───┐·║ 
─╜·│  │·│     │·│    │·│   │·╙─
─┘·└──┘·└─────┘·└───┐│·└───┘·└─
········ ······■····││·········
─┐·┌──────┐·┌─┐·┌─┐·└┘·┌───┐·┌─
─╖·│      │·│ │·│ │····│   │·╓─
 ║·└──────┘·└─┘·└─┘·┌┐·│┌──┘·║ 
 ║··················││·││····║ 
 ║·┌┐·┌─────┐·╥·╥·┌─┘│·││·┌┐·║ 
 ║·││·└─────┘·║·║·└──┘·└┘·││·║ 
 ║·││·········║·║·········││·║ 
 ║·││·┌─────┐·║·║·┌─────┐·││·║ 
 ║·││·└─┐   │·╨·╨·│   ┌─┘·││·║ 
 ║·││···│  ┌┘·····└┐  │···││·║ 
 ║·│└─┐·│  │·······│  │·┌─┘│·║ 
 ║·└──┘·└──┘·······└──┘·└──┘·║ 
 ║■·························■║ 
 ╚═══════════════════════════╝ 
 ┌─╒═══════════════════════╕─┐ 
 │ │···········■···········│ │ 
 │ │·┌────┐·┌─┐·┌─┐·┌────┐·│ │ 
 │ │·│┌───┘·│ │·│ │·└──┐ │·│ │ 
 │ │·││·····│ │·│ │····│ │·│ │ 
 │ │·││·┌─┐·└─┘·└─┘·┌┐·└─┘·│ │ 
 │ │·││·│ │·········││·····│ │ 
 │ │·││·│ └─┐·┌─┐·┌─┘│·┌─┐·│ │ 
 ╓─┘·└┘·└───┘·└─┘·└──┘·└─┘·└─╖ 
 ║···························║ 
 ║·╥·┌┐·╥·╥·•·•·•·•·┌┐·┌───┐·║ 
 ║·║·││·║·║·········││·│   │·║ 
 ║·╨·└┘·╨·╨·•·•·•·•·││·└───┘·║ 
 ║■····· ···········││······■║ 
 ║·┌──┐·┌─┐·╞═╡·╥·╥·└┘·┌───┐·║ 
 ║·│  │·│ │·····║·║····│   │·║ 
 ║·└──┘·│ │·╞═╡·╨·╨·┌┐·│┌──┘·║ 
 ║······│ │·········││·││····║ 
 ║·┌┐·╥·│ └─┐·┌─┐·┌─┘│·││·┌┐·║ 
 ║·││·╨·└───┘·└─┘·└──┘·└┘·││·║ 
 ║·││··········■··········││·║ 
 ║·││·┌─────┐·┌─┐·┌┐·┌──┐·││·║ 
 ║·└┘·└─┐   │·│ │·││·│┌─┘·││·║ 
 ║······│   │·└─┘·││·││···││·║ 
 ║·┌──┐·│   │·····││·││·┌─┘│·║ 
 ║·└──┘·└───┘·┌─┐·└┘·└┘·└──┘·║ 
 ║············│ │············║ 
 ╚════════════╛─╘════════════╝ 
 ┌─╒═══════════════════════╕─┐ 
 │ │■·····················■│ │ 
 │ │·┌──┐·┌───┐·┌────┐·┌─┐·│ │ 
 │ │·│┌─┘·└─┐ │·│ ┌──┘·│ │·│ │ 
 │ │·││·····│ │·│ │····│ │·│ │ 
 │ │·││·┌─┐·└─┘·└─┘·┌┐·└─┘·│ │ 
 │ │·││·│ │·········││·····│ │ 
 │ │·││·│ └─┐·┌─┐·┌─┘│·┌─┐·│ │ 
 ╓─┘·└┘·└───┘·└─┘·└──┘·└─┘·└─╖ 
 ║···························║ 
 ║·┌──┐·┌─┐·•·•·•·•·┌┐·┌───┐·║ 
 ║·│  │·│ │·········││·│   │·║ 
 ║·└──┘·└─┘·•·•·•·•·││·└───┘·║ 
 ║······ ···········││·······║ 
 ║·┌──────┐·┌─┐·┌─┐·└┘·┌───┐·║ 
 ║·│      │·│ │·│ │····│   │·║ 
 ║·└──────┘·└─┘·└─┘·┌┐·│┌──┘·║ 
 ║··················││·││····║ 
 ║·┌┐·┌─────┐·╥·╥·┌─┘│·││·┌┐·║ 
 ║·││·└─────┘·║·║·└──┘·└┘·││·║ 
 ║·││·········║·║·········││·║ 
 ║·││·┌─────┐·║·║·┌─────┐·││·║ 
 ║·││·└─┐   │·╨·╨·│   ┌─┘·││·║ 
 ║·││···│  ┌┘·····└┐  │···││·║ 
 ║·│└─┐·│  │·······│  │·┌─┘│·║ 
 ║·└──┘·└──┘·······└──┘·└──┘·║ 
 ║■·························■║ 
 ╚═══════════════════════════╝ 
 ┌─╒═══════════════════════╕─┐ 
 │ │·······················│ │ 
 │ │·┌──┐·┌───┐·┌────┐·┌─┐·│ │ 
 │ │·│┌─┘·└─┐ │·│ ┌──┘·│ │·│ │ 
 │ │·││·····│ │·│ │····│ │·│ │ 
 │ │·││·┌─┐·└─┘·└─┘·┌┐·└─┘·│ │ 
 │ │·││·│ │·········││·····│ │ 
 │ │·││·│ └─────────┘│·┌─┐·│ │ 
 ╓─┘·└┘·└────────────┘·└─┘·└─╖ 
 ║·········■·······■·········║ 
 ║·┌──┐·┌─┐·•·•·•·•·┌┐·┌───┐·║ 
 ║·│  │·│ │·········││·│   │·║ 
 ║·└──┘·└─┘·•·•·•·•·││·└───┘·║ 
 ║······ ···········││·······║ 
 ║·┌──────┐·•·•·•·•·└┘·┌───┐·║ 
 ║·│      │············│   │·║ 
 ║·└──────┘·•·•·•·•·┌┐·│┌──┘·║ 
 ║·········■·······■││·││····║ 
 ║·┌┐·┌─────┐·╥·╥·┌─┘│·││·┌┐·║ 
 ║·││·└─────┘·║·║·└──┘·└┘·││·║ 
 ║·││·········║·║·········││·║ 
 ║·││·┌─────┐·║·║·┌─────┐·││·║ 
 ║·││·└─┐   │·║·║·│   ┌─┘·││·║ 
 ║·││···│  ┌┘·║·║·└┐  │···││·║ 
 ║·│└─┐·│  │··║·║··│  │·┌─┘│·║ 
 ║·└──┘·└──┘··╨·╨··└──┘·└──┘·║ 
 ║···························║ 
 ╚═══════════════════════════╝ 
 ┌─╒═══════════════════════╕─┐ 
 │ │·······················│ │ 
─┘ │·┌──┐·┌───┐·┌────┐·┌─┐·│ └─
───┘·│┌─┘·└─┐ │·│ ┌──┘·│ │·└───
·····││··■··│ │·│ │···■│ │·····
───┐·││·┌─┐·└─┘·└─┘·┌┐·└─┘·┌───
─┐ │·││·│ │·········││·····│ ┌─
 │ │·││·│ └─────────┘│·┌─┐·│ │ 
 ╓─┘·└┘·└────────────┘·└─┘·└─╖ 
 ║········· ······· ·········║ 
 ║·┌──┐·┌─┐·•·•·•·•·┌┐·┌───┐·║ 
 ║·│  │·│ │·········││·│   │·║ 
 ║·└──┘·└─┘·•·•·•·•·││·└───┘·║ 
 ║······ ······ ····││·······║ 
 ║·┌──────┐·•·•·•·•·└┘·┌───┐·║ 
 ║·│      │············│   │·║ 
 ║·└──────┘·•·•·•·•·┌┐·│┌──┘·║ 
 ║········· ······· ││·││····║ 
┌╜·┌┐·┌─────┐·╥·╥·┌─┘│·││·┌┐·║ 
╛┘·││·└─────┘·║·║·└──┘·└┘·││·╚═
···││■········║·║·····■···││···
╕┐·││·┌─────┐·║·║·┌─────┐·││·╔═
└╖·││·└─┐   │·║·║·│   ┌─┘·││·║ 
 ║·││···│  ┌┘·║·║·└┐  │···││·║ 
 ║·│└─┐·│  │··║·║··│  │·┌─┘│·║ 
 ║·└──┘·└──┘··╨·╨··└──┘·└──┘·║ 
 ║···························║ 
 ╚═══════════════════════════╝ 
 ┌─╒═══════════════════════╕─┐ 
 │ │·······················│ │ 
─┘ │·┌──┐·┌──────────┐·┌─┐·│ └─
───┘·│┌─┘·└─┐     ┌──┘·│ │·└───
·····││··■··│     │···■│ │·····
───┐·││·┌─┐·└──~──┘·┌┐·└─┘·┌───
─┐ │·││·│ │·········││·····│ ┌─
 │ │·││·│ └─┐·┌─┐·┌─┘│·┌─┐·│ │ 
 ╓─┘·└┘·│ ┌─┘·└─┘·└─┐│·└─┘·└─╖ 
 ║······│ │ ······· ││·······║ 
 ║·┌──┐·│ │·•·•·•·•·││·┌───┐·║ 
 ║·│  │·│ │·········││·│   │·║ 
 ║·└──┘·└─┘·•·•·•·•·││·└───┘·║ 
 ║······ ······ ····││·······║ 
 ║·┌──────┐·•·•·•·•·││·┌───┐·║ 
 ║·│      │·········││·│   │·║ 
 ║·└──────┘·•·•·•·•·││·│┌──┘·║ 
 ║········· ······· ││·││····║ 
┌╜·┌┐·┌─────┐·╥·╥·┌─┘│·││·┌┐·║ 
╛┘·││·└─────┘·║·║·└──┘·└┘·││·╚═
···││■········║·║·····■···││···
╕┐·││·┌───────╜·╙───────┐·││·╔═
└╖·││·└─┐     │·│     ┌─┘·││·║ 
 ║·││···│     │·│     │···││·║ 
 ║·│└─┐·│     │·│     │·┌─┘│·║ 
 ║·└──┘·└─────┘·└─────┘·└──┘·║ 
 ║···························║ 
 ╚═══════════════════════════╝ 
 ┌─╒═══════════════════════╕─┐ 
 │ │·······················│ │ 
 │ │·┌──┐·┌──┐·•·┌───┐·┌─┐·│ │ 
 │ │·│┌─┘·└─┐│···│┌──┘·│ │·│ │ 
 │ │·││··■··││·╥·││···■│ │·│ │ 
 │ │·││·╥·•·└┘·╨·└┘·┌┐·└─┘·│ │ 
 │ │·││·║···········││·····│ │ 
 │ │·││·║·┌─┐·┌─┐·┌─┘│·┌─┐·│ │ 
 ╓─┘·└┘·║·└─┘·└─┘·└─┐│·└─┘·└─╖ 
─╜······║···········││·······╙─
─┘·┌──┐·║·•·•·•·•·•·││·┌───┐·└─
···│  │·║···········││·│   │···
─┐·└──┘·╨·•·•·•·•·•·││·└───┘·┌─
─╖······ ···········││·······╓─
 ║·┌────┐·•·•·•·•·•·││·┌───┐·║ 
 ║·│    │···········││·│   │·║ 
 ║·└────┘·•·•·•·•·•·││·│┌──┘·║ 
 ║··················││·││····║ 
┌╜·┌┐·┌─┐·┌─┐·╥·╥·┌─┘│·││·┌┐·║ 
╛┘·││·└─┘·└─┘·║·║·└──┘·└┘·││·╚═
···││■········║·║·····■···││···
╕┐·││·┌─┐·•·•·║·║·•·╥·┌─┐·││·╔═
└╖·││·└─╖·····║·║···║·╓─┘·││·║ 
 ║·││···║·•·•·║·║·•·╨·║···││·║ 
 ║·│└─┐·║·····║·║·····║·┌─┘│·║ 
 ║·└──┘·╚═════╝·╚═════╝·└──┘·║ 
 ║···························║ 
 ╚═══════════════════════════╝ 
 ┌─╒═══════════════════════╕─┐ 
┌┘ │·······················│ │ 
└──┘·┌──┐·┌──┐·•·┌───┐·┌─┐·└─┘ 
·····│┌─┘·└─┐│···└───┘·│ │·····
┌──┐·││··■··││·╥······■│ │·┌─┐ 
└┐ │·││·•·•·└┘·╨·╞╡·┌┐·└─┘·│ │ 
 │ │·││·············││·····│ │ 
 │ │·││·•·┌─┐·┌─┐·╥·││·┌─┐·│ │ 
 ╓─┘·└┘···└─┘·└─┘·╨·││·└─┘·└─╖ 
─╜······╥···········││·······╙─
─┘·╞══╡·║·•·•·•·•·•·││·┌───┐·└─
········║···········││·│   │···
─┐·╞══╡·╨·•·•·•·•·•·││·└───┘·┌─
─╖······ ···········││·······╓─
 ║·┌────┐·•·•·•·•·•·││·┌───┐·║ 
 ║·│    │···········││·│   │·║ 
 ║·└────┘·•·•·•·•·•·││·│┌──┘·║ 
 ║··················││·││····║ 
┌╜·┌┐·┌─┐·┌─┐·╥·╥·┌─┘│·││·┌┐·║ 
╛┘·││·└─┘·└─┘·║·║·└──┘·└┘·││·╚═
···││■········║·║·····■···││···
╕┐·││·┌─┐·•·•·║·║·•·╥·┌─┐·││·╔═
└╖·││·└─╖·····║·║···║·╓─┘·││·║ 
 ║·││···║·•·•·║·║·•·╨·║···││·║ 
 ║·│└─┐·║·····║·║·····║·┌─┘│·║ 
 ║·└──┘·╚═════╝·╚═════╝·└──┘·║ 
 ║···························║ 
 ╚═══════════════════════════╝ 
 ┌─╒═══════════════════════╕─┐ 
┌┘ │·······················│ │ 
└──┘·┌──┐·┌──┐·•·┌───┐·┌─┐·└─┘ 
·····│┌─┘·└─┐│···└───┘·│ │·····
┌──┐·││··■··││·╥······■│ │·┌─┐ 
└┐ │·││·•·•·└┘·╨·╞╡·┌┐·└─┘·│ │ 
 │ │·││·············││·····│ │ 
 │ │·││·•·┌─┐·┌─┐·╥·││·┌─┐·│ │ 
 ╓─┘·└┘···└─┘·└─┘·╨·││·└─┘·└─╖ 
─╜······╥···········││·······╙─
─┘·╞══╡·║·•·•·•·•·•·││·┌───┐·└─
········║···········││·│   │···
─┐·╞══╡·╨·•·•·•·•·•·││·└───┘·┌─
─╖······ ···········││·······╓─
 ║·┌────┐·•·•·•·•·•·││·┌───┐·║ 
 ║·│    │···········││·│   │·║ 
 ║·└────┘·•·•·•·•·•·││·│┌──┘·║ 
 ║··················││·││····║ 
┌╜·┌┐·┌─┐·┌─┐·╥·╥·┌─┘│·││·┌┐·║ 
╛┘·││·└─┘·└─┘·║·║·└──┘·└┘·││·╚═
···││■········║·║·····■···││···
╕┐·││·┌─┐·•·•·║·║·•·╥·┌─┐·││·╔═
└╖·││·└─╖·····║·║···║·╓─┘·││·║ 
 ║·││···║·•·•·║·║·•·╨·║···││·║ 
 ║·│└─┐·║·····║·║·····║·┌─┘│·║ 
 ║·└──┘·╚═════╝·╚═════╝·└──┘·║ 
 ║···························║ 
 ╚═══════════════════════════╝ 
