size 6x6
1 1 1 1 1 0
1 6 2 2 1 1
1 4 3 5 2 1
1 2 2 1 2 1
1 2 2 2 2 1
1 1 1 1 1 1