size 7x7
0 1 1 1 1 0 0
0 1 2 2 1 1 1
1 1 2 4 3 2 1
1 2 3 3 2 2 1
1 2 1 4 2 4 1
1 6 2 2 1 1 1
1 1 1 1 1 0 0