# Diamond Girl map v1.0
TIME=100
GAME_SPEED=3
AMEBA_TIME=0
DIAMOND_SCORE=4
TIME_SCORE=1
DIAMONDS_NEEDED=12
WIDTH=40
HEIGHT=20

DIAMOND=!
SAND=%
BOULDER=*
BRICK=#
BRICK_EXPANDING=z
BRICK_UNBREAKABLE=Z
AMEBA=a
EMPTY=.
ENEMY1=1
ENEMY2=2
START=S
END=E

DATA=
ZZZZZZZZZZZZZZZZZZZZZZZZZZZZZZZZZZZZZZZZ
ZSE%%%%%%%%%%%%%%%%%%%%%%%%%%%%%%%%%%%%Z
Z%%%%%%%%%%%%%%%%%%%%%%%%%%%%%%%%%%%%%%Z
Z%%%%...%%%...%%%...%%%...%%%...%%%...%Z
Z%%%%...%%%...%%%...%%%...%%%...%%%...%Z
Z%%%%2!.%%%2!.%%%2!.%%%2!.%%%2!.%%%2!.%Z
Z%%%%%%%%%%%%%%%%%%%%%%%%%%%%%%%%%%%%%%Z
Z%%%%%%%%%%%%%%%%%%%%%%%%%%%%%%%%%%%%%%Z
Z%%%%%%%%%%%%%%%%%%%%%%%%%%%%%%%%%%%%%%Z
Z%%%%%%%%%%%%%%%%%%%%%%%%%%%%%%%%%%%%%%Z
Z%%%%%%%%%%%%%%%%%%%%%%%%%%%%%%%%%%%%%%Z
Z%%%%...%%%...%%%...%%%...%%%...%%%...%Z
Z%%%%...%%%...%%%...%%%...%%%...%%%...%Z
Z%%%%2!.%%%2!.%%%2!.%%%2!.%%%2!.%%%2!.%Z
Z%%%%%%%%%%%%%%%%%%%%%%%%%%%%%%%%%%%%%%Z
Z%%%%%%%%%%%%%%%%%%%%%%%%%%%%%%%%%%%%%%Z
Z%%%%%%%%%%%%%%%%%%%%%%%%%%%%%%%%%%%%%%Z
Z%%%%%%%%%%%%%%%%%%%%%%%%%%%%%%%%%%%%%%Z
Z%%%%%%%%%%%%%%%%%%%%%%%%%%%%%%%%%%%%%%Z
ZZZZZZZZZZZZZZZZZZZZZZZZZZZZZZZZZZZZZZZZ
