size 6x8
1 1 1 1 1 0 0 0
1 6 2 4 1 1 1 1
1 2 5 2 3 2 2 1
1 2 3 1 2 1 2 1
1 2 2 2 4 2 2 1
1 1 1 1 1 1 1 1