GreenRiver { 
	BALL_COLORS {
		255 000 000
		000 255 000
		000 000 255
		000 255 255
	}
	MAP {
		ENDR HHDD HHHH HHHH HHHH HHHH HHHH HHHH HHDD STRL 
		BLNK SPIN HHHH HHHH HHHH HHHH HHHH HHHH SPIN BLNK 
		BLNK MOVE SPIN BL1H HHHH HHHH HHHH HHHH SPIN BLNK 
		BLNK SPIN HHHH HHHH HHHH HHHH HHHH HHHH SPIN BLNK 
		BLNK SPIN HHHH HHHH HHHH HHHH BL3H SPIN LEVL BLNK 
		BLNK SPIN HHHH HHHH HHHH HHHH HHHH BL4H SPIN BLNK 
		BLNK BLNK BLNK BLNK BLNK BLNK BLNK BLNK BLNK BLNK 
		
	}
}
