TheWanderer { 
	BALL_COLORS {
		255 000 000
		000 255 000
		000 000 255
		000 255 255
	}
	MAP {
		ENDR HHDD HHHH HHHH HHHH HHHH HHHH HHHH HHDD STRL 
		BLNK SPIN HHHH HHHH HHHH HHHH HHHH HHHH SPIN BLNK 
		BLNK VVVV SPIN HHHH HHHH HHHH HHHH SPIN VVVV BLNK 
		BLNK VVVV VVVV LEVL PATT MOVE NEXT VVVV VVVV BLNK 
		BLNK VVVV SPIN HHHH HHHH HHHH HHHH HHVV SPIN BLNK 
		BLNK SPIN HHHH HHHH HHHH HHHH HHHH SPIN BLNK BLNK 
		BLNK BLNK BLNK BLNK BLNK BLNK BLNK BLNK BLNK BLNK 
		
	}
}
