size 6x8
0 0 0 1 1 1 1 1
1 1 1 1 2 4 2 1
1 2 6 3 2 2 2 1
1 2 2 2 5 5 2 1
1 2 2 2 2 1 1 1
1 1 1 1 1 1 0 0