0 0 0 0 0 0 0 0 0 0 0 0 0 0 0 
0 1 1 1 1 1 1 1 1 1 1 1 1 1 0 
0 1 0 0 0 0 0 0 0 0 0 0 0 1 0 
0 1 0 0 0 0 0 0 0 0 0 0 0 1 0 
0 1 0 0 2 1 1 1 1 1 0 0 0 1 0 
0 1 0 0 1 1 1 1 1 1 0 0 0 1 0 
0 1 0 0 1 1 1 1 1 1 0 0 0 1 0 
0 1 0 0 1 1 1 1 1 1 0 0 0 1 0 
0 1 0 0 1 1 1 1 1 1 0 0 0 1 0 
0 1 0 0 1 1 1 1 1 1 0 0 0 1 0 
0 1 0 0 0 0 0 0 0 0 1 0 0 1 0 
0 1 0 0 0 0 0 0 0 0 0 0 0 1 0 
0 1 0 0 0 0 0 0 0 0 0 0 0 1 0 
0 1 1 3 1 1 1 1 1 1 1 1 1 1 0 
0 0 0 0 0 0 0 0 0 0 0 0 0 0 0 
0 0 0 0 0 0 0 0 0 0 0 0 0 0 0 
RED 7 11
YELLOW 6 11
BLUE -1 -1
RED -1 -1
GREEN -1 -1
GREEN -1 -1
NONE -1 -1
NONE -1 -1
NONE -1 -1
NONE -1 -1
