0 0 0 0 0 0 0 0 0 0 0 0 0 0 0 
0 0 0 0 0 0 0 0 0 0 0 0 0 0 0 
0 0 0 0 0 0 0 0 0 0 0 0 0 0 0 
0 1 1 1 1 1 1 2 1 1 1 1 1 1 0 
0 1 0 0 0 0 0 0 0 0 0 0 0 1 0 
0 1 0 0 0 0 0 0 0 0 0 0 0 1 0 
0 1 0 0 0 0 0 0 0 0 0 0 0 5 0 
0 3 0 0 0 0 0 0 0 0 0 0 0 1 0 
0 1 0 0 0 1 1 4 1 1 0 0 0 1 0 
0 1 0 0 0 1 0 0 0 1 0 0 0 1 0 
0 1 1 1 1 1 0 0 0 1 1 1 1 1 0 
0 0 0 0 0 0 0 0 0 0 0 0 0 0 0 
0 0 0 0 0 0 0 0 0 0 0 0 0 0 0 
0 0 0 0 0 0 0 0 0 0 0 0 0 0 0 
0 0 0 0 0 0 0 0 0 0 0 0 0 0 0 
0 0 0 0 0 0 0 0 0 0 0 0 0 0 0 
RED 10 9
GREEN 4 9
BLUE 12 9
YELLOW 2 9
NONE -1 -1
NONE -1 -1
NONE -1 -1
NONE -1 -1
NONE -1 -1
NONE -1 -1
