0 0 0 0 0 0 0 0 0 0 0 0 0 0 0 
0 0 0 0 0 0 0 0 0 0 0 0 0 0 0 
0 0 0 0 0 0 0 0 0 0 0 0 0 0 0 
0 0 0 0 1 5 1 1 0 0 0 0 0 0 0 
0 0 0 0 1 0 0 1 0 0 0 0 0 0 0 
0 0 1 1 1 0 0 1 1 1 0 0 0 0 0 
0 0 4 0 0 0 0 0 0 1 0 0 0 0 0 
0 0 1 0 0 0 0 0 0 3 0 0 0 0 0 
0 0 1 1 1 0 0 1 1 1 0 0 0 0 0 
0 0 0 0 1 0 0 1 0 0 0 0 0 0 0 
0 0 0 0 1 1 2 1 0 0 0 0 0 0 0 
0 0 0 0 0 0 0 0 0 0 0 0 0 0 0 
0 0 0 0 0 0 0 0 0 0 0 0 0 0 0 
0 0 0 0 0 0 0 0 0 0 0 0 0 0 0 
0 0 0 0 0 0 0 0 0 0 0 0 0 0 0 
0 0 0 0 0 0 0 0 0 0 0 0 0 0 0 
RED 8 6
YELLOW 5 9
GREEN 6 4
BLUE 3 7
NONE -1 -1
NONE -1 -1
NONE -1 -1
NONE -1 -1
NONE -1 -1
NONE -1 -1
