:Double Trouble
########################
# .       @     .      #
#  ####          ####  #
# #.   *        #    # #
# #    #        #    # #
# #    #        # ** # #
# # ** #        #    # #
# #    #        #    # #
# #    #        *   .# #
#  ####          ####  #
#      .             . #
########################
