C
2 3 7 7 5 7 4 4
 2 - 4 - 7 - 7 
- 7 4 3 4 3 2 -
 - 5 - - - 2 - 
- 4 7 0 5 7 4 -
 2 - 3 - 5 - 0
3 0 3 5 0 5 7 5F
