C
1 1 1 1 1 1 1 1
 1 - - - - - 1
1 - - 3 4 5 0 0
 1 - - - 2 6 3 
1 - - - - - 6 3
 0 0 - - - - -
0 3 0 3 - - - -
 4 2 0 4 2F
