C
- 6 6 - - 2 2 -
 - 3 - - - 3 - 
- 2 - - - 3 - -
 - 4 - - - 0 -
- 3 - - - 3 - -
 - 0 - - - 7 -
- 3 - - - 3 - -
 - 2 - - - 3F
