C
4 4 4 5 5 5 5 8
 4 4 5 8 8 8 7 
4 4 8 8 3 3 - -
 4 8 7 3 - - -
- - 7 3 7 - - -
 - 8 8 3 3 8 - 
- - - 8 3 8 - -
 - - - 8 8 F
