C
- 1 - 1 - 0 - 3
 4 - 5 - 4 - 2 
4 - 5 - 3 - 3 -
 - 5 - 5 - 1 -
- 2 - 2 - 0 - -
 4 - 0 - 2 - -
- - 1 - 4 - - -
 - - - 2F
