7888000088088884	maze data ..maze two
9D88599688F88849
9388816888F88499
99788F8888F84999
3534728888F49999
3019308888199999
9999997884999359
9999999D859999A9
9999993888599999
999996F88882FFF5
99993B9AEE7B9964
999968F288201349
999688F88805C999
996888F884388599
9688881782280825
688888228888288B

77,CC,FF#		Teleporters

5A,7A,BA,E7		Havens

11			door
21,3
