The Maze:
EAEEEEEEEEEEEEEE
E38080800808084E
E3B9E9E31E9E9E9E
E38F0F8FF8F0F81E
E9E3F1E31E3F1E9E
E38F2F8FF8F2F81E
E9E9E9E31E9E9E9E
E30F0F0FF0F0F01E
E32F2F2FF2F2F21E
E9E9E9E31E9E9E9E
E38F0F8FF8F0F81E
E9E3F1E31E3F1E9E
E38F2F8FF8F2F81E
E9D1E9E31E9E9E9E
E68282822828285E
EEEEEEEEEEEEEEEE
The teleporters:
#
The havens:
44B44BBB
The door:
10
11
0
