The Maze:
7008808888088004
35388F8888F88161
30F88F8888F88F01
999D8F8888F8B999
3FF00F0000F00FF1
999993FFFF199999
999993FFFF199999
999993FFFF199999
999993FFFF199999
999993FFFF199999
999993FFFF199999
3FF22F2222F22FF1
999D8F8888F8B999
32F80F8888F88F21
34382F8888F88171
6228828888288225
The teleporters:
11E1778778881EEE#
The havens:
33C33CCC
The door:
3E
4E
3
a gonk
