...#####.............
..#vvvvv#............
.#vvvvvvv#...........
#>>vvvvv<<#..........
#>>>___<<<#..........
#>>>_S_<<<########...
#>>>___<<<vvvvvvvv#..
#>>>___<<vvvvvvvvvv#.
#>>>__o<vvvvvvvvvv<<#
#>>>_____o_______<<<#
#>>>___________E_<<<#
#>>>_o___________<<<#
#>>>^^^^^^^^^^^^^^<<#
.#>^^^^^^^^^^^^^^^^#.
..#^^^^^^^^^^^^^^^#..
...###############...
@4@Safe turn@