####..<<<<<<...
#S__<.<<<<<<EE.
#___<<<<^^.<EE.
.__.<<<<^^..__.
.__.........o_.
.__..vvvvv..__.
._o..__~__..__.
.__.._____.._o.
.o_.._o.__..__.
.__..__.__..__.
.__..__._o..__<
.___o__.___o__<
.___~__.___~__<
.^^^^^^.^^^^^^.
@8@Twisting@