\\\\\\\\\\\\\\\\\\\\\\\\\\\\\\\\\\\\\\\\\\\\\\\\\\\\\\\\\\\\\\\\\\\\\\\
\                                                                     \
\                                                                     \
\                                                                     \
\                                                                     \
\                                                                     \
\                                                                     \
\                                                                     \
\                                                                     \
\                                                                     \
\                                                                     \
\                 ###################                                 \
\                 #   #  #   #v #   #                                 \
\                 #      #   #  #   #                                 \
\                 #   # v#   #  #   #                                 \
\                 #  !#  #   #  # h #                                 \
\                 #####  #   #      #                                 \
\                 #   #  #   #  #####                                 \
\                 #h  #  #   #  #   #                                 \
\                 #      #####v #v  #                                 \
\                 #   #v #   #      #                                 \
\                 #h  #      #  #   #                                 \
\                 #####  #   #  #####                                 \
\                 #   # v#####  #   #                                 \
\                 #            v#   #                                 \
\                 #   #             #                                 \
\                 #   #         #v  #                                 \
\                 #####         #####                                 \
\                 #   #v            #                                 \
\                 #   #         #   #                                 \
\                 #             #   #                                 \
\                 #   #       v #   #                                 \
\                 #####         #####                                 \
\                 #   # v       #   #                                 \
\                 #   #v # ###    v #                                 \
\                 #      #   #  #   #                                 \
\                 # h #  ### #  #   #                                 \
\                 #   #  ### #  #####                                 \
\                 #####  ###v#v #  h#                                 \
\                 #   # v### #  #   #                                 \
\                 #      ### #v     #                                 \
\                 #   #  ### #  #  h#                                 \
\                 #   #  ### #  #####                                 \
\                 #   #  #   #  #   #                                 \
\                 ##### v# ###      #                                 \
\                 #   #      *  #   #                                 \
\                 #             #  v#                                 \
\                 #  h#         #   #                                 \
\                 # v #         #####                                 \
\                 #####         #   #                                 \
\                 #   #             #                                 \
\                 #      h  v   #   #                                 \
\                 #v  #         #   #                                 \
\                 # v #   h     #####                                 \
\                 #  v#  #####  #   #                                 \
\                 #####  #   # v#   #                                 \
\                 #   #  #   #      #                                 \
\                 #  h   #   #  #  v#                                 \
\                 #   #  #   #  #####                                 \
\                 #   #  #   #  #   #                                 \
\                 #####  #   #    h #                                 \
\                 #  h   #   #  #   #                                 \
\                 #   #  #   #  #!  #                                 \
\                 ###################                                 \
\                                                                     \
\                                                                     \
\\\\\\\\\\\\\\\\\\\\\\\\\\\\\\\\\\\\\\\\\\\\\\\\\\\\\\\\\\\\\\\\\\\\\\\
