........................!!!.........................!!!..............................
........................!!!.............!!!........!!!...............................
.......!!!!!..............!!!.........!!!!!.......!!!................................
........!!!!..............!!!.........!!!!......!!!!.................................
...........................!!!................!!!!...................................
....||บบบบบบบบบบบบบบบ.......!!!...............................บบบบบบบบบบบบบบบบบบ.....
...|||บþþþþþþþþþþþþþบบบบบบบบบบบบบบบบบบบบบบบบบบบบบบบบบบบบบบบบบบบþþþþþþþþþþþþþþþþบ.....
..!!!!บþþþþþþþþþþþþþþþþþþþþþþþþþþþþþþþþþþþþþþþþþþþþþþþþþþþþþþþþþþþþþþþþþþþþþþþþบ.....
.!!!!!บþþþบบบบบบบบบบบบ/บบบบบบบบบบบบบบบบบบบบบบบบบบบบบบบบบบบบบบบบบบบบบบบบบบบบþþþþบ.....
!!!!!!บþþþบþþþþþCTCþþþþþCTCþþบบบþþþþþþþþþบ%บþþþþþþþþþบþþþþþþþþþþþþþþþþþþþþบþþþþบ.....
.!!!!!บþþþบþþþþþþþþþþþþþþþþþþfþบþþþþþþþþþþþþþþþþþþþþþบþþþCþþþþþþþþþþCþþþþþบþþþþบ.....
..!!!!บþþþบþþþþþþþþþþþþþþþþþþoþบþþþþþþþþþþþþþþþþþþþþþบþþCTCþþþþþþþþCTCþþþþบþþþþบ.....
...!!!บþþþบþþþþþþþþþþþþþþþþþþoþบบþþþOþþþþþþþþþþþOþþþþบþþþCþþþþþþþþþþCþþþþþบþþþþบ.....
....!!บบþþบspiritsบþþþCþþþCþþdþบþþþþþþþþþþþþþþþþþþþþþบþþþþþþþþþþþþþþþþþþþþบþþþþบ.....
.....!.บþþบþþþþþþþบþþCTCþCTCþบบบบþþþþþþþþþþþþþþþþþþþþบþþþþþþþþþþþþþþþþþþþþบþþþบบ.....
....|!.þþþบบบบบบบบบบบบบบบบบบบบบบþþþþOþþþþþþþþþþþOþþþþบþþþþþþþþþþþþþþþþþþþþบþþþบ......
.......þþþþþþþþþþþþþþþþþþþþþþþþบþþþþþþþþþþþþþþþþþþþþþบบบบบบบบบบบบบบบบบบบ/บบþþþบ......
.......þþþþþþþþþþþþþþþþþþþþþþþþ/þþþþþþþþþþþþþþþþþþþþþ/þþþþþþþþþþþþþþþþþþþþ/þþþบ...!!.
.......þþþþþþþþþþþþþþþþþþþþþþþþบþþþþþþþþþþþþþþþþþþþþþบþþþþþþþþþþþþþþþþþþþþบþþþบ..!!!!
.......þþþþþþþþþþþþþþþþþþþþþþþþบþþþþþþþþþþþþþþþþþþþþþบþþþþþþþþþþþþþþþþþþþþบþþþบ..!!!.
....|!.þþþบบบบบบบþþþþþþþþบบบบบบบþþþþOþþþþþOþþþþþOþþþþบบบบบบบบบบบบบบบบบบบบบบþþþบ..!!!.
.....!.บþþบþþþþþบþþþþþþþþบþþþCþบþþþþþþþþþþþþþþþþþþþþþบþþþþþþþþþþþþþþþþþþþþþþþþบ......
....!!.บþþบþþTþþบþþþþþþþþ/þþCTCบþþþþþþþþþþþþþþþþþþþþþบþþþþþþþþþþþþþþþþþþþþþþþþบ......
...!!!.บþþบþþþþþบþþþþþþþþบþþþCþบþþþþþþþþþþþþþþþþþþþþþบþþþþþþþþþþþþþþþþþþþþþþþþบ......
..!!!!.บþþบþþþþþบþþþþþþþþบบบบบบบบบบบบบบบบบบบบบบบบบบบบบþþþþบบบบบบบบ/บบบบบบบบþþþบ......
.!!!!!.บþþบþþþþþบþþþþþþþþþþþþþþþþþþþþþþþþþþþþþþþþþþþþþþþþþบþþþþþþþþþþþþþþþบþþþบ......
!!!!!!บบþþบþþþþþบþþþþþþþþþþþþþþþþþþþþþþþþþþþþþþþþþþþþþþþþþบþþþþþþþþþþþþþþþบþþþบ......
.!!!!!บþþþบþþ{_}บþþþþþþþþþþþþþþþþþþþþþþþþþþþþþþþþþþþþþþþþþบþþþþþþþþþþþþþþþบþþþบบ.....
..!!!!บþþþบ/บบบบบบบบบบþþþþþþþบบบบบบบบ/บบบบบบบบบþþþþþþþþþþþบþþบarmouryบþþþþบþþþþบ.....
...!!!บþþþบþบþþþบþþþþบþþþþþþþบþþþþþþþþþþþþþþþþบþþþþþþþþþþþบþþบþþþþþþþบþþþþบþþþþบ.....
....||บþþþบþบinnบþþþþบþþþþþþþบþþþþþþþþþþþþþþþþบบบบบบ/บบบบบบบบบบบบบบบบบบ/บบบþþþþบ.....
....||บþþþบþþþþþþþþþþþþþþþþþþบþþþþþþþþþþþþþþþþบþþþþþþþþþþþCþบþCþþþþþþþþþþþบþþþþบ.....
......บþþþบþþTþþþþþþþþþþþþþþþบþบarmamentบþþþþþบþþþþþþþþþþCTCบCTCþþþþþþþþþþบþþþþบ.....
......บþþþบþþþþþþþþþþบþþþþþþþบþบþþþþþþþþบþþþþþบþþþþþþþþþþþCþบþCþþþþþþþþþþþบþþþþบ.....
!!!...บþþþบบบบบบบบบบบบบบบบบบบบบบบบบบบบบบบบบบบบบบบบบบบบบบบบบบบบบบบบบบบบบบบบบþþþþบ.....
!!!!..บþþþþþþþþþþþþþþþþþþþþþþþþþþþþþþþþþþþþþþþþþþþþþþþþþþþþþþþþþþþþþþþþþþþþþþþþบ.....
.!!!!.บþþþþþþþþþþþþþþþþþบบบบบบบบบบบบบบบบบบบบบบบบบบบบบบบบบบบþþþþþþþþþþþþþþþþþþþþบ.....
..!!!.บบบบบบบบบบบบบบบบบบ..................................บบบบบบบบบบบบบบบบบบบบบบ.....
...!!!!...................................!!!........................................
....!!!!................|||.............!!!!!................................!!!!....
.....!!!!..............|||||...........!!!!!.................................!!!!....
......!!!!............||..|||...........!!!!........................|........!!!.....
.......!!!!..........||....||......................................|||.......!!......
