................|||||||||||||||.......................||||||||||||||||||||...........
..............||||||||||||||......................||||||||||||||||||||...........||||
............||||||||||||||....................|||||||||||||||||||||.............|||||
...........||||||||||......................|||||||||||||||||||||..............|||||||
..|||........................................................................|||||||.
..|.....฿฿฿฿฿/฿฿฿฿฿฿฿฿฿฿฿฿฿฿฿฿฿฿฿฿฿฿฿฿฿฿฿฿฿฿฿฿฿฿฿฿฿฿฿฿฿฿฿฿฿฿฿฿฿฿฿฿฿฿฿฿฿฿฿฿฿฿฿...||||.
.|||...฿.............||||||||||.................|||||||||||..................฿....||.
..|||.฿.|||.............||||||||||||..............|||||||||||.............|||.฿......
..|||.฿..|||บบบบบบบบบบบบบบบบบบบบบบบบบบบบบบบบบบบบบบบบบบบบบบบบบบบบบบบบบบบบบ.|||.฿......
..|||.฿..|||บþCþþþบþCþþþบþCþþþบþCþþþบþCþþþบþCþþþบþCþþþบþCþþþบþCþþþบþCþþþบ.|||.฿......
.|||..฿..|||บþþþþþ/þþþþþ/þþþþþ/þþþþþบþþþþþบþþþþþ/þþþþþ/þþþþþ/þþþþþ/þþþþþบ..|||฿......
.|||..฿.|||.บþþþþþบþþþþþบþþþþþบþþþþþบþþþþþบþþþþþบþþþþþบþþþþþบþþþþþบþþþþþบ...||฿..|||.
.|||..฿..|||บบบ/บบบบบบบบบบบบบบบบบ/บบบบบบ/บบบบ/บบบบบบบบบบบบบบบบบบบบบบบ/บบบ.|||.฿..|||.
..|||.฿.|||.บþCþþþบþCþþþบþCþþþบþCþþþบþCþþþบþCþþþบþCþþþบþCþþþบþCþþþบþCþþþบ.|||.฿..|||.
..|||.฿.|||.บþþþþþ/þþþþþ/þþþþþ/þþþþþ/þþþþþบþþþþþ/þþþþþ/þþþþþบþþþþþ/þþþþþบ.....฿..|||.
..|||.฿..|||บþþþþþบþþþþþบþþþþþบþþþþþบþþþþþบþþþþþบþþþþþบþþþþþบþþþþþบþþþþþบ.|||.฿.|||..
..|||.฿..|||บบบบบบบบบ/บบบบบ/บบบบบบบบบบบบบบบบบบบบบบบบบบบบบ/บบบบบบบบบบบ/บบบ..|||฿..|||.
..|||.฿..|||บþCþþþบþCþþþบþCþþþบþCþþþบ...........บþCþþþบþCþþþบþCþþþบþCþþTบ.|||.฿..|||.
..|||.฿.|||.บþþþþþ/þþþþþบþþþþþ/þþþþþบ..7888889../þþþþþ/þþþþþบþþþþþ/þþþþþบ.|||.฿..|||.
.|||..฿.|||.บþþþþþบþþþþþบþþþþþบþþþþþบ..4~~~~~6..บþþþþþบþþþþþบþþþþþบþþþþþบ..|||฿.|||..
..|||.฿..|||บบบ/บบบบบบบบบบบบบบบบบ/บบบ..4~~~~~6..บบบบบบบบบ/บบบบบ/บบบบบบบบบ.....฿..|||.
..|||.฿.|||.บþCþþþบþCþþþบþCþþþบþCþþþบ..4~~~~~6..บþCþþþบþCþþþบþCþþþบþCþþþบ.....฿..|||.
.|||..฿..|||บþþþþþบþþþþþ/þþþþþ/þþþþþบ..1222223../þþþþþบþþþþþบþþþþþ/þþþþþบ.....฿..|||.
..|||.฿..|||บþþþþþบþþþþþบþþþþþบþþþþþบ...........บþþþþþบþþþþþบþþþþþบþþþþþบ.....฿..|||.
.|||..฿.|||.บบบ/บบบบบ/บบบบบบบบบบบบบบบบบ/บบบบบ/บบบบบ/บบบบบ/บบบบบ/บบบบบ/บบบ..||.฿..||..
.|||..฿..|||บþCþþþบþCþþþบþCþþþบþCþþþบþCþþþบþCþþþบþCþþþบþCþþþบþCþþþบþCþþþบ..||.฿..|||.
..||..฿..|||บþþþþþบþþþþþ/þþþþþ/þþþþþ/þþþþþ/þþþþþบþþþþþ/þþþþþบþþþþþบþþþþþบ..||.฿.|||..
.|||..฿.|||.บþþþþþบþþþþþบþþþþþบþþþþþบþþþþþบþþþþþบþþþþþบþþþþþบþþþþþบþþþþþบ..||.฿.|||..
.||...฿..|||บบบ/บบบบบ/บบบบบบบบบบบบบบบบบ/บบบบบบบบบบบบบบบบบบบบบบบบบบบบบ/บบบ.||..฿..||..
..||..฿.|||.บþCþþþบþCþþþบþCþþþบþCþþþบþCþþþบþCþþþบþCþþþบþCþþþบþCþþþบþCþþþบ.|||.฿.|||..
..||..฿..|||บþþþþþ/þþþþþ/þþþþþ/þþþþþ/þþþþþ/þþþþþ/þþþþþ/þþþþþ/þþþþþบþþþþþบ.|||.฿..||..
..||..฿.|||.บþþþþþบþþþþþบþþþþþบþþþþþบþþþþþบþþþþþบþþþþþบþþþþþบþþþþþบþþþþþบ..|||฿..|||.
.|||..฿..|||บบบบบบบบบบบบบบบบบบบบบบบบบบบบบบบบบบบบบบบบบบบบบบบบบบบบบบบบบ/บบบ.....฿..|||.
..|||.฿...|||.......................||||||||||||..............|||||||||||.....฿..|||.
.|||..฿....||||||||||||||.............||||||||||||..............||||||||||....฿...||.
.|||...฿..........|||||||||||||||........||||||||||||..............|||||||...฿.......
........฿฿฿฿฿฿฿฿฿฿฿฿฿฿฿฿฿฿฿฿฿฿฿฿฿฿฿฿฿฿฿฿฿฿฿฿฿฿฿฿฿฿฿฿฿฿฿฿฿฿฿฿฿฿฿฿฿฿฿฿฿฿฿฿฿/฿฿฿....|||.
...............................|||||||||||||||||||||.........................|||||||.
..........................|||||||||||||||||||||||||........................|||||||||.
....................|||||||||||||||||||||||||...........................|||||||||||||
................||||||||||||||||||||||||||............................|||||||||||||..
............||||||||||||||||||||||||...............................||||||||||||||....
........|||||||||||||||||||||||||................................||||||||||||||......
...|||||||||||||||||||||||.....................................||||||||||||||........
