!!!!!!............................!!!!!!.........................!!!!!!!.......!!!!..
.!!!!!!..........................!!!!!!........................!!!!!!!........!!!!!!.
..!!!!!!!.......................!!!!!!.......................!!!!!!!..........!!!!!!!
...!!!!!!!.....................!!!!!!.......................!!!!!!!............!!!!!!
.....!!!!!!..................!!!!!!........................!!!!!!!!............!!!!!!
.....บบบบบบบบบบบบบบบบบบบบบบบบบบบบบบบบบบบบบบบบ/บบบบบบบบบบบบบบบบบบบบบบบบบบบบบบบบบบ.!!!!
.....บþþþþþþþþþþþþþþþþþþþþþþþþþþþsþþบ..........................................บ.....
!!!!!บบfþþþþCþþþþþþCþþþþþCþþþþþþþpþþบ.|..|........|..|..|..|..|.....|..|..|..|.บ.....
!!!!!บþoþþþCTCþþþþCTCþþþCTCþþþþþþiþþบ..........................................บ.....
!!!!!บþoþþþþCþþþþþþCþþþþþCþþþþþþþrþþบ.|..|........|..|..|..|..|.....|..|..|..|.บ.....
!!!!!บบdþþþþþþþþþþþþþþþþþþþþþþþþþiþþบ..........................................บ.....
!!!!.บþþþþþþþþþþþþþþþþþþþþþþþþþþþtþþบ.|..|........|..|..|..|..|.....|..|..|..|.บ.....
.....บþþþþþþþþþþþþþþþþþþþþþþþþþþþsþþบ..........................................บ.....
.....บบบบบบบบ/บบบบบบบบบบ/บบบบบบบบบบบบบบบบบบบบบ/บบบบบบบบบบบบบบบบบบบบบบบบบบบบบบบบบ.....
.....บþþþþþþþþþþþþþþบþþþþþþþþþþþþþþþþþþþþþþþþþþþþþþþþþþþþþþþþþþþþþþþþþþþบþþþCþþบ.....
.....บ{_}þþþþþþþþþþþบþþþþþþþþþþþþþþþþþþþþþþþþþþþþþþþþþþþþþþþþþþþþþþþþþþþบþþCTCþบ.....
.....บþþþþþþþþþþþ{_}บþþþþþþþþþþþþþþþþþþþþþþþþþþþþþþþþþþþþþþþþþþþþþþþþþþþบþþþCþþบ.....
.....บ{_}þþþþþþþþþþþบþþþþบบบบบบบบบบบบบบบบบบบบบบบบบบบบบบบบบบบบบบบบบบบþþþþบþþþþþþบ.....
.....บþþþþþþþþþþþ{_}บþþþþบþ{__}þþþþþþþþþþบ.........................บþþþþบþþþCþþบ.....
...!!บ{_}þþþþþþþþþþþบþþþþบþþþþþþþþþCþþþþþบ........!!!!!!!!!!.......บþþþþบþþCTCþบ.....
..!!!บþþþþþþþþþþþ{_}บþþþþบþþþþþþþþCTCþþþþ/.......!.........!.......บþþþþบþþþCþþบ.....
..!!!บthe poorhouseþบþþþþบþþþþþþþþþCþþþþþบ......!...78889.!........บþþþþบþþþþþþบ.....
..!!!บบบบบบบบบบบบบบบบþþþþบบบบบบบบบบบบบบบบบ.....!...7ณ~~~น9.!.......บþþþþบþþþCþþบ.....
..!!!บþþþบþþþþบþþþþþบþþþþþþþþþþþþþþþþþþþþบ.....!..7ณ~~~~~น9.!......บþþþþบþþCTCþบ..!!!
..!!!บþþþarmourþþþþþบþþþþþþþþþþþþþþþþþþþþบ.....!..1ซ~~~~~~น9.!.....บþþþþบþþþCþþบ...!!
...!!บþþþþþþþþþþþCþþบþþþþบบบบบบบบบบบบþþþþบ......!..1ซ~~~~~~6..!....บþþþþบบบ/บบบบ..!!!
.....บþþþþþþþþþþCTCþบþþþþบþþþþþþþþþþบþþþþบ.......!..12222223.!.....บþþþþบþþþþþþบ.....
.....บþþþþþþþþþþþCþþบþþþþบþCþCþCþþþþบþþþþบ........!!!!!!!!!!!......บþþþþ/þþþþþþบ.....
.....บþþþþþþþþþþþþþþบþþþþบþþþþþþþþþþบþþþþบบบบบบบบบบบบบบ/บบบบบบบบบบบบþþþþบþþþþþþบ.....
.....บบบบบบบ/บบบบบบบบþþþþบþCþCþCþþþþบþþþþþþþþþþþþþþþþþþþþþþþþþþþþþþþþþþþบþþþþþþบ.....
.....บþCþþþþþþþþþþþþบþþþþบþþþþþþþþþþบþþþþþþþþþþþþþþþþþþþþþþþþþþþþþþþþþþþบþþþþþþบ.....
.....บCTCþþþþþþþþþþþบþþþþบþCþCþCþþTCบþþþþบบบบบบบ/บบบบบบบบบบบบบบบบบบบบบบบบบบบ/บบบ.....
.....บþCþþþþþþþþþþþþ/þþþþ/þþþþþþþþþþบþþþþบþþþþþþþþþþþþJþบþþþCþþบþþþþþþþþþþþþþþþบ.....
.....บþþþþþþþþþþþþþþบþþþþบþCþCþCþþþþบþþþþบþþþþþþþþþþþþJþบCþþþþþ/þþþþþþþþþþþþþþþบ.....
.....บþþweaponsþþþþþบþþþþบþþþþþþþþþþบþþþþบJJJJJJJJJJJJJþบþþþþþþบþþþþlodgingþþþþบ.....
.....บþþบþþþþþบþþþþþบþþþþบþCþCþCþþþþบþþþþบþþþþþþþþþþþþþþบþ{_}þþบþþþþบþþþþþบþþþþบ.....
.....บบบบบบบบบบบบบบบบบบบบบบบบบบบบบบบบบ/บบบบบบบบบบบบบบบบบบบบบบบบบบบบบบบบบบบบบบบบบ.....
...........!!!!!!!................!!!!.!!!!...................!!!!!!!!!!!............
..........!!!!!!!..............!!!!!....!!!!.................!!!!!!!!!!!!!!..........
.........!!!!!!!..............!!!!!......!!!!!..............!!!!!!...!!!!!!!.........
........!!!!!!!............!!!!!..........!!!!!............!!!!!!......!!!!!!........
.......!!!!!!!............!!!!!............!!!!!..........!!!!!!.........!!!!!!......
......!!!!!!!............!!!!!..............!!!!!........!!!!!.............!!!!!!....
.....!!!!!!!............!!!!!................!!!!!......!!!!!!..............!!!!!!!!.
