..............!!!!!.............!!!!!!...............!!!!............................
.!!!!!!........!!!!!!............!!!!!!.............!!!!!!......!!!!!!!!!!!!!!!......
..!!!!!!........!!!!!!...........!!!!!!............!!!!!!.....!!!!!!!!!!!!!!!!.......
....!!!!..........!!!!!!..........!!!!!!..........!!!!!!....!!!!!!!!!!!!!!!!!........
.....................................................................................
.....!!!!!!!!!!!!!!!!!!!!!!!!!!!!!!!!!!!|...|!!!!!!!!!!!!!!!!!!!!!!!!!!!!!!!!!!!..!!!
.....!..........................!!!!....|...|..................................!.!!!!
.....!..บบบบบบบบบบบบบบบบบบบบบบ..!!!!....|...|...บบบบบบบบบบบบบบ...!!!!!!!.......!!!!!!
.....!..บþCþþบþCþþบþþCþบþþþCþบ..!!!!....|...||||บþþþþþþþþCþþþบ...!!!!!!!!......!!!!!!
.....!..บCTCþบCTCþ/þCTC/þþCTCบ...!!!!...|......./þþþþþþþCTCþþบ....!!!!!!!!.....!.!!!!
.....!..บþCþþบþCþþบþþCþบþþþCþบ..!!!!!...|...||||บþþþþþþþþCþþþบ.....!!!!!!!!....!...!!
.....!..บบบ/บบบบ/บบบบบบบบบบบบบ..!!!!!...|...|...บþþþCþþþþþþþþบ.................!.....
.....!..บþþþþþþþþþþþþþþþþþþþþบ.!!!!.....|...|...บþþCTCþþþþþþþบบบบบบบบบบบบบบ.!!.!..!!!
.....!..บ/บบบบบบบบบบบบบบบบบบบบ..!!!!....|...|...บþþþCþþþþþþþþþþþþþþþþCþþþþบ.!!.!.!!!!
.....!..บþþþþþþþþCTþþþþþþþþþþบ.!!!!.....|...|...บþþþþþþþþþþþþþCþþþþþCTCþþþบ.!!!!!!!!!
.....!..บþCþCþCþCþCþCþCþCþCþCบ.!!!!!....|...|...บบtavernบþþþþCTCþþþþþCþþþþ/.!!!!.!!!!
.....!..บþþþþþþþþþþþþþþþþþþþþบ.!!!!!....|...|...บบþþþþþþบþþþþþCþþþþþþþþþþþบ.!!!!..!!!
.....!..บþCþCþCþCþCþCþCþCþCþCบ..!!!!....|...|...บบบบบบบบบบบบบบบบบบบบบบบบบบบ.!!!!...!!
.....!..บบบบบบบบบบบบบบบบบบ/บบบ..........|...|.............!!!!!............!!!.!.....
.....!..................|...|...........|...|...........!!!!!..............!!..!.....
.....!..................|...|||||||||||||...|||||||||||||||||||||||||||||||||||!.....
.....!..................|............................................................
.....!..........!!!!!!!!|............................................................
.....!........!!!!!!!!!!|...|||||||||||||...|||||||||||||||||||||||||||||||||||!.....
.....!.....!!!!!!!!!!!!.|...|...........|...|............!!!!!!!!!.............!...!!
.....!...!!!!!!!!!!!!!..|...|...บบบบบบบบบบ/บบบบบบบบบบบบบบบบบบบบบบบบบบบบบบบบบบ..!..!!!
.....!.!!!!!!!!!!!!.....|...|...บþþþþþþþþþþþþþþþþþþþþþþþþþþþþþþþþþþþþþþþþþþþบ..!.!!!!
.....!!!!!!!!!!!!.......|...|...บþþþþþþþþþþþþþþþþþþþþþþþþþþþþþþþþþþþþþþþþþþþบ..!.!!!!
.....!..................|...|...บþþþþþþþþþþþþþþþþþþþþþþþþþþþþþþþþþþþþþþþþþþþบ..!..!!!
.....!.....||||||||||||||...|...บþþþþþþþþþþþþþþþþþþþþþþþþþþþþþþþþþþþþþþþþþþþบ!!!.!!!!
.....!.....|................|...บบบบบบบบบบ/บบบบบบบบบบบบบบบบ/บบบบบบบบบบบ/บบบบบ..!!!!!!
.....!.....|................|...บþþþþþþþþþþþþþþþþþþþþบþþþþþþþþþþþþบþþþþþþþþþบ!!!.!!!!
.....!.....|...||||||||||||||...บþþþþþþþþþþþþþþþþþþþþบþþþþþþþþþþþþบþþþþþþþþþบ!!!..!!!
.....!.....|...|......!!!!!!....บþþþบweaponsบþþþþþþþþบþþบarmourบþþบþบfoodบþþบ!!!...!!
.....!.....|...|.....!!!!!!.....บþþþบþþþþþþþบþþþþþþþþบþþบþþþþþþบþþบþบþþþþบþþบ..!....!
.....!.....|...|....!!!!!!......บบบบบบบบบบบบบบบบบบบบบบบบบบบบบบบบบบบบบบบบบบบบบ..!.....
.....!.....|...|...!!!!!!.............!!!!!!!!!!!!!!!!!!!!!!!!!!!!!!!!!!!!!!!..!.....
.....!!!!!!!...!!!!!!!!!!!!!!!!!!!!!!!!!!!!!!!!!!!!!!!!!!!!!!!!!!!!!!!!!!!!!!!!!.....
.!!!!!!.....................!!!!!!!!!!!..............!!!!!!!!!.......................
..!!!!!!...................!!!!!!!!!!!............!!!!!!!!!!...........!!!!!!!!!!!...
...!!!!!!................!!!!!!!!!!!!...........!!!!!!!!!!........!!!!!!!!!!!!!!!!...
....!!!!!!!.............!!!!!!!!!!!!..........!!!!!!!!!!.........!!!!!!!!!!!!........
......!!!!!!!..........!!!!!!!!!!!!.........!!!!!!!!!!..........!!!!!!!!!!!!.........
.......!!!!!!!!.......!!!!!!!!!!!..........!!!!!!!!!!.........!!!!!!!!!!!!!..........
