/* Boston levels */

"l1",
	0,3,4,	17,5,100,		16,5,120,		15,5,150,

"l2",
	3,0,1,	14,3,100,		13,3,120,		13,3,140,

"l3",
	2,2,0,	14,4,100,		13,4,120,		13,4,140,

"l4",
	1,3,4,	20,5,80,		18,5,100,		18,5,120,

"l5",
	0,1,0,	15,4,100,		14,4,120,		14,4,150,

"l6",
	3,3,2,	18,3,100,		16,3,120,		15,3,140,

"l7",
	0,2,4,	16,4,120,		14,4,140,		13,4,160,

"l8",
	3,1,3,	16,3,140,		14,3,160,		13,3,190

end
