C
8 - - 0 6 - - 8
 8 - 6 0 2 - 8
8 - - 0 6 - - 8
 8 - 5 4 3 - 8
8 - - 5 4 - - 8
 8 - 1 4 5 - 8
8 - - - - - - 8
 8 - - - - - 8F
 
