C
7 7 7 7 7 7 7 7
 8 8 8 8 8 8 7
6 6 6 6 6 6 6 6
 6 8 8 8 8 8 8
5 5 5 5 5 5 5 5
 8 8 8 8 8 8 5
4 4 4 4 4 4 4 4
 4 8 8 8 8 8 8
3 3 3 3 3 3 3 3
 8 8 8 8 8 8 3F
