#Mures map
Version 1.1
Type Battle

Data
+-+-+-+-+-+-+-+-+-+-+-+-+
|                       |
+ + + + + + + + + + + + +
|                       |
+ + + + + + + + + + + + +
|    1             2    |
+ + + + + + + + + + + + +
|          U R          |
+ + + + + + + + + + + + +
|                       |
+ + + + + + + + + + + + +
|          L D          |
+ + + + + + + + + + + + +
|    4             3    |
+ + + + + + + + + + + + +
|                       |
+ + + + + + + + + + + + +
|                       |
+-+-+-+-+-+-+-+-+-+-+-+-+
