0 0 0 0 0 0 0 0 0 0 0 0 0 0 0 
0 1 1 1 4 1 1 1 1 1 1 1 1 1 0 
0 1 0 0 0 0 0 0 0 0 0 0 1 1 0 
0 1 0 0 0 2 0 0 0 0 0 0 0 1 0 
0 1 0 1 0 1 0 1 0 0 0 0 0 1 0 
0 1 0 1 0 1 0 1 0 1 0 0 0 1 0 
0 1 0 1 0 1 0 1 0 1 0 0 0 1 0 
0 1 0 1 0 1 0 1 0 1 0 0 0 1 0 
0 1 0 0 0 1 0 1 0 1 0 0 0 1 0 
0 1 0 0 0 0 0 5 0 0 0 0 0 1 0 
0 1 0 0 0 0 0 0 0 0 0 0 0 1 0 
0 1 0 0 0 0 0 0 0 0 0 0 0 1 0 
0 1 0 0 0 0 0 0 0 0 0 0 0 1 0 
0 1 1 1 1 1 1 1 1 3 1 1 1 1 0 
0 0 0 0 0 0 0 0 0 0 0 0 0 0 0 
0 0 0 0 0 0 0 0 0 0 0 0 0 0 0 
GREEN 2 2
YELLOW 4 2
BLUE 3 10
RED 7 12
NONE -1 -1
NONE -1 -1
NONE -1 -1
NONE -1 -1
NONE -1 -1
NONE -1 -1
