0 0 0 0 0 0 0 0 0 0 0 0 0 0 0 
0 1 1 1 1 1 1 1 1 3 1 1 1 1 0 
0 1 0 0 0 0 0 0 0 0 0 0 0 1 0 
0 1 0 0 0 0 0 0 0 0 0 0 0 4 0 
0 5 0 0 0 0 0 0 0 0 0 0 0 1 0 
0 1 0 0 1 0 0 1 0 0 1 0 0 1 0 
0 1 0 0 1 1 1 1 1 1 1 0 0 1 0 
0 1 0 0 1 1 1 1 1 1 1 0 0 1 0 
0 1 0 0 1 1 1 1 1 1 1 0 0 1 0 
0 1 0 0 1 1 1 1 1 1 1 0 0 1 0 
0 1 0 0 1 1 1 1 1 1 1 0 0 1 0 
0 1 0 0 0 0 0 0 0 0 0 0 0 1 0 
0 1 0 0 0 0 0 0 0 0 0 0 0 1 0 
0 1 1 1 1 1 1 1 1 1 1 1 1 1 0 
0 0 0 0 0 0 0 0 0 0 0 0 0 0 0 
0 0 0 0 0 0 0 0 0 0 0 0 0 0 0 
BLUE 9 2
YELLOW 5 5
GREEN 9 11
RED -1 -1
GREEN -1 -1
GREEN -1 -1
NONE -1 -1
NONE -1 -1
NONE -1 -1
NONE -1 -1
