169
111111
111111
111111
111111
111111
111111
111111
111111
111111
111111
111111
111111
111111
111111
111111
111111
111111
111111
111111
111111
111111
111111
111111
111111
111111
111111
111111
111111
111111
444444
111111
111111
111111
123212
111111
212121
111111
321212
111111
212121
111111
121212
111111
888188
111111
115111
221581
117111
111211
111111
111188
113111
111111
155511
111111
218111
111122
111111
221122
111111
118811
111111
221122
111111
116711
171161
116711
181181
111111
111111
211312
111111
112211
121121
111111
111115
211111
111118
221222
111111
111111
822221
111111
111113
898111
111111
111808
117111
111211
711111
117111
111171
111115
113111
111111
121121
111111
212212
111111
181181
111111
131111
112211
111111
221122
111111
112211
131111
111888
221111
115111
112111
118115
191122
111211
112101
711113
121111
111111
111222
111111
123212
111111
212121
111111
888188
111111
111111
111911
111111
555555
181818
111111
111111
103231
111111
111111
111111
111111
111111
111111
111111
111111
111111
111111
111111
111111
111111
111111
111111
111111
111111
111111
111111
111111
111111
111111
111111
111111
111111
111111
111111
111111
111111
111111
111111
111111
111111