162
111111
111111
111111
111111
111111
111111
111111
111111
111111
111111
111111
111111
111111
111111
111111
111111
111111
111111
111111
111111
111111
111111
111111
111111
111111
111111
111111
111111
111111
444444
171131
118111
111110
555555
222222
111162
111211
191111
111111
113111
221188
111111
111111
112211
111111
711116
171161
111111
111111
112211
111111
111311
181111
111181
119111
111111
811818
111111
111111
112121
111111
111111
111011
121112
111111
111111
131111
111121
111111
891218
111111
111111
112111
111131
111111
121111
111111
111212
111161
131711
111161
111711
111111
111111
181181
111111
811118
111111
118011
111111
111113
111111
881111
111112
111111
111111
112211
111111
181111
111188
111111
811111
111131
111111
111151
111111
111161
111611
116111
181118
111111
111111
221122
119011
111111
112211
111111
111121
222111
111111
111112
113111
111111
111111
180811
111111
111111
111188
811111
111111
211111
121122
111111
111211
112112
111111
111111
111111
111111
111111
111111
111111
111111
111111
111111
111111
111111
111111
111111
111111
111111
111111
111111
111111
111111
111111
111111
111111
111111
111111
111111
111111