112
111111
111111
111111
111111
111111
111111
111111
111111
111111
111111
111111
111111
111111
111111
111111
111111
111111
111111
111111
111111
111111
111111
111111
111111
111111
111111
111111
111111
111111
444444
111111
111111
111291
111111
111112
102111
111111
211111
111131
112111
111111
212021
111111
131111
111921
121111
111211
112111
111111
111111
113111
111111
921122
111111
111011
112111
111111
111111
121121
911110
111111
112211
221122
111111
131111
211112
151011
111111
121111
111292
111111
112111
111112
101131
292111
111188
111111
131111
111112
221121
111111
171111
112211
111111
111111
111111
111111
111111
111111
111111
111111
111111
111111
111111
111111
111111
111111
111111
111111
111111
111111
111111
111111
111111
111111
111111
111111
111111
111111
111111
111111
111111