111
111111
111111
111111
111111
111111
111111
111111
111111
111111
111111
111111
111111
111111
111111
111111
111111
111111
111111
111111
111111
111111
111111
111111
111111
111111
111111
111111
111111
111111
444444
112111
111111
113111
111111
111212
111111
121111
111121
112111
112113
111111
211191
111111
111131
112111
121111
111011
110111
111121
131211
111111
111121
221122
111211
112111
112191
112111
191122
112111
911111
111111
131211
111121
221111
111111
112211
111211
112111
112131
112111
111111
111121
122111
111111
211311
121111
111922
111111
111111
123111
111211
111111
119111
111111
111111
111111
111111
111111
111111
111111
111111
111111
111111
111111
111111
111111
111111
111111
111111
111111
111111
111111
111111
111111
111111
111111
111111
111111
111111
111111
111111