80
60
################################################################################
#56  b               #            FFF     k        # = #                       #
#78  #   #           #            FFF############# #$# #   %                   #
#     # #     A      #               #    ######## #$# #                       #
#      #       C     #               #    ######## #k# #                       #
#     # #  A         #          B    #    ######## #F#3#                       #
# ?  #   #           #         B     #   F######## #?# #                       #
#   ?     A          #        B      #  F ######## ###=#                       #
#           ?   $$$  #       B       # F  ########   k #                       #
#               $$$ k#    C     C    =  A ########   k #                       #
#==###################      C  C     =    ########=#####=#######################
#k# $                #       C       =    ########       #                     #
# #                  #   2   2       =    ########      #                      #
#F#  1               #               =    ########     #                       #
#C#                  #  1     3      =    ########    #                        #
#b#    b             #$$F            =    ########   #   k                     #
#b#                  #################    ########  #                          #
#b#             FFFFF#k$$$FF$$       =    ######## #                           #
# ##### ##############$$$$    $  === =    ######## #                           #
#     =           =$$$$$$    $ ===1= =    ######## #                           #
#     =  k        =$$$         =  #===    ######## #                           #
#     =A          =$$===  ?    ===        ######## #                           #
#     = A         =$$=1=       #2=        ######## #                           #
#======           ====#===========        ######## #                           #
#   A                                   # ######## #                           #
#  A                                   #$$######## #                           #
#                                 F   #B$$######## #                           #
##################################################=#                           #
# k                                          #  =                              #
########################################### ##  ################################
#                                           #                                  #
#                                           #################################  #
#                                           #                 #                #
#                                           #                 #                #
#                                           #      #          #                #
#                                           #      #          #                #
#                                           #      #          #                #
#                                           #      #          #                #
#                                           #      #          #                #
#                                           #      #          #                #
#                                           #      #          #                #
#                                           #      #                           #
#                                           #      #                           #
#                                           # ##################################
#                                           #                                  #
#                                           #                                  #
#                                           #                                  #
#                                           #                                  #
#                                           #                                  #
#                                           #                                  #
#                                           #                                  #
#                                           #                                  #
#                                           #                                  #
#    #####                                  #                                  #
#       ######                              #                                  #
#          #######                          #                                  #
#              #####                        #                                  #
#                 ###########################                                  #
#                                                                              #
################################################################################
