
!0
!1


1 *1111111111111111
2 *1e01e01e01e01e01
3 *1k01k01k01k01k01
4 *1101101101101101
5 *3044044044044044
6 *30r0000000030003
7 *30r0000003030303
8 *30r0000003030303
9 *30r0000003030303
10*30r0000003030303
11*p0r000000300030q
12*3333333333333333
