
!3
"YOU HAVE ENTERED THE SHADOWY"
"HALLS OF PAGANITZU. GOOD LUCK"
"ON YOUR JOURNEY, ADVENTURER."

!0


1 *11011111114444z4
2 *11p11110wwXn44z4
3 *11011110ww4cxxv4
4 *1000000022444444
5 *1000000022000dd4
6 *10r111111133kBXx
7 *100000s111333Z00
8 *1011111111333CXN
9 *101111111133333Z
10*500000000000004z
11*5665k000000ddd4z
12*5555555q5555555c
