
!0
!0

1 *3333333333333303
2 *30000000000000p3
3 *3T200002111111d3
4 *302020r01sddd1d3
5 *30k20Y001r00r1d3
6 *30000kr01ddds1d3
7 *300020201r00r1d3
8 *300000201sddd1d3
9 *300000000r0001d3
10*3000k000111111d3
11*3838383810y00003
12*333333333q333333
