

!0
!0

1 *4444444444444444
2 *4s00Y0Y0Y0000000
3 *4k011111111k100p
4 *4d00000000000004
5 *4330333333333884
6 *43303333333wwww4
7 *4k00k000000rr0wx
8 *400000k00000rrr4
9 *40000000k000rr04
10*400000000000000s
11*480080808000000q
12*4444444444444444
