

!1
"JUST LIKE BOULDERDASH"
!0

1 *q222222222222222
2 *2k0000u222222222
3 *2222222222222222
4 *222222u00000k222
5 *2222222222222222
6 *2222222222222222
7 *22k2220222k22222
8 *2202220222022222
9 *22u2220222022222
10*220222y222022222
11*220222k222y222p2
12*2222222222222222
