
!0
!0

1 *p444444444444444
2 *00Y0000000000004
3 *4033333333333304
4 *4000000000000004
5 *4000000y00000k04
6 *4t30033333000004
7 *4030000000003004
8 *4000000000T30004
9 *4000003000033004
10*400003e300000004
11*4k0000000000000q
12*4444444444444444
