

!2
"YOU MAY WANT TO THINK BEFORE"
"YOU LEAP"
!0

1 *4444444444444444
2 *4000000r6675000q
3 *400r000076750d04
4 *400r000000r50d04
5 *4p0000000005ud04
6 *4d00000000r50d04
7 *4d0s000000r50004
8 *4d00000000055524
9 *4d0000r000055224
10*4d0000k000s52224
11*4d000000000000s4
12*4484444444444444
