size 7x7
1 1 1 1 1 0 0
1 2 2 2 1 0 0
1 2 1 2 1 1 1
1 4 2 3 3 2 1
1 4 2 2 1 2 1
1 2 2 5 6 2 1
1 1 1 1 1 1 1