
!0
!0

1 *4444444444333333
2 *p00000000033dd03
3 *440010001033ddd3
4 *440t10001U333333
5 *440010001033kkk3
6 *4400100010330003
7 *4400r00010330103
8 *4400111T1003010q
9 *4000000011030103
10*044444400003t103
11*44444k0000000003
12*4444444444433333
