
!0
!0

1 *5555555555555555
2 *p000000000000005
3 *555r555555555525
4 *55w0002000r00005
5 *5ww0005555555r05
6 *5ww0005kk5kk5005
7 *50w0005005005dd5
8 *5Tw0005005005ddq
9 *50w0000055505555
10*00wwwwwwwwXXNkk5
11*002000000000Zkk5
12*555555555555z555
