
!0
!0

1 *5555555555555555
2 *Xwwwwwwwwwwwwww5
3 *5kkk11111111dddq
4 *500010k11k01dkd5
5 *5rrr100ss001ddd5
6 *5000100000010005
7 *50k0100000012r25
8 *5rrr1s0000s1rrr5
9 *5000000000000005
10*5555500rr0055555
11*50y002000020000p
12*5555555555555555
