
!0
!0

1 *1453345103454443
2 *50Y00003p5000003
3 *404430000000000q
4 *40E0y0ddd0053111
5 *401350ddd0020005
6 *50Y0e00005410w03
7 *3055100004000w04
8 *10E00053540www05
9 *10004810000www04
10*1000131000wwww05
11*5k00020000000005
12*5345314353344413
