
!3
"MY, IT'S DARK IN HERE, ISN'T"
"IT? I WONDER IF SOME LIGHT"
"COULD BE SHED ON THE SUBJECT..."
!2

1 *3015351145334435
2 *1p54000000000005
3 *10140ky0k0k00k03
4 *503500rr000rr001
5 *50000k00k0k00k01
6 *3104000000000001
7 *40040k00k0kY0k04
8 *501400rr000rr005
9 *40010k00k0k00k04
10*3505000000000003
11*000131133q343315
12*4131333530435535
