
!0
!0

1 *3333333333333333
2 *3000000000000003
3 *30r004k4k4k4k403
4 *30000000000r0003
5 *3003330303030303
6 *11r1138383838303
7 *1000133333333323
8 *10r01s0000000003
9 *10001d00000000d3
10*10001d00000000d3
11*10p01s00000000Y3
12*11011333333333q3
