
!0
!0

1 *3333333033333333
2 *3000000p00000003
3 *301010k00k010103
4 *301u10000001u103
5 *301d101dd101d103
6 *3011101dd1011103
7 *3011101dd1011103
8 *301d101dd101d103
9 *301t10000001t103
10*301010k00k010103
11*3000000000000003
12*33333333q3333333
