

!0
!0

1 *3333333333333333
2 *p000000000000001
3 *3000000000000001
4 *30r000000000000s
5 *3tr0000000000001
6 *30r0000000000001
7 *300000000000000s
8 *30000r0000000kd1
9 *3000tr0000000dk1
10*30000r0000000kd1
11*3000000000000dkq
12*1111111111188111
