

!0
!0

1 *BXXXXXXXXXXXXN0P
2 *Z00000000000sZ00
3 *Zprrrr0000000w00
4 *Z00000000000www0
5 *Z000000y0000www0
6 *Zw0000BXN000www0
7 *Zw0000ZkZ0000w00
8 *Z00000CXV0000000
9 *Zww0000000000www
10*Zddww000000000ww
11*ZPddw0ww0000000q
12*CXXXXXXXXXXXXXww

*15000110

