

!0
!0

1 *1111111111111111
2 *qP0000000000000s
3 *11111111111110r1
4 *P1s0000y000d10k1
5 *d1d0bxnrr00d[001
6 *d[d0zkzpr00d1001
7 *d1d0cxvrr00d[001
8 *d1s00000000d1001
9 *P111111111111001
10*4000400040004081
11*P040004000400041
12*1111111111111111

*00100008
*00030101
