
!0
!0

1 *3344434444343434
2 *q01140000000y00s
3 *4011401040011103
4 *300d4T1040000004
5 *400d4010404ddd03
6 *300d4010404ddd84
7 *300d401040444444
8 *300d4010400000p4
9 *300d401040000043
10*400d401040000043
11*488dk00044888844
12*4444434334433443
