
!0
!0

1 *555q555555555555
2 *5000000000006555
3 *5010r00000005555
4 *50100000k00000s5
5 *5010k00000000005
6 *5011s0000k000r05
7 *50110k0000000005
8 *5010r00k000000s5
9 *501000000k000555
10*50100www00044444
11*p01wwwwwXN0bxn44
12*5wwwwwww0cxv4cxx
