
!2
"HINT: TRY TRAPPING THE SPIDER"
"      BETWEEN THE BOULDERS."
!0

1 *z444444033333333
2 *cw40000p33333333
3 *ww40111111111111
4 *ww40100000e00001
5 *4440r00dddddd001
6 *3337100000000001
7 *3333100000000001
8 *00rr000dddddd001
9 *3033100000000001
10*3033111111111111
11*30000000000000kq
12*3333333333333333
