size 7x8
1 1 1 1 1 1 1 0
1 6 2 4 4 2 1 1
1 2 3 2 1 2 2 1
1 2 1 3 3 2 2 1
1 2 2 2 1 2 2 1
1 4 2 2 1 2 2 1
1 1 1 1 1 1 1 1