100
0000400000000000
0001010000000000
0000000000000000
0000400000000000
0001010000000000
0000000000000000
0000000000000000
0101011140000000
2099132672
1
0
1
1
1
0
0
0
Antigravity