45
4000000000000040
0000000000000000
0000000000000000
0000000000000000
0000000000000000
0000000000000000
1000000000000000
0011001100110011
1688864955
3
0
1
1
1
0
0
0
Mooooooore antigravity :)