40
0100000000000001
0100000000000001
0100420000000001
0101010049000001
0100000012000001
0100000101000001
0100000100000001
0100490100004001
750179489
0
0
1
1
1
0
0
0
Tricky colors