150
0046000000000000
0049460000000000
0040494600000000
0045404946000000
0044454049460000
0043444540494600
0042434445404946
0043424344454049
-2069875807
0
0
1
1
1
0
0
0
It gets harder...