120
0000400000000000
0000490000000000
0000400000000000
0000490007000000
0000400007000000
0000490007000000
0708000907000000
0707110700000000
169288448
2
0
1
1
1
0
0
0
