90
4042414000000000
4241404200000000
4640424600000000
4344434400000000
0000000000000000
0000000000000000
0800080009000900
0011001100110000
1688864944
0
0
1
1
1
0
0
0
Simple level!