120
0000000000000000
0000000000004140
0101010001010101
4041510000510051
0101014101010100
0000004001000000
0000004101000000
0000001101111111
-1827012567
0
0
1
1
1
0
0
0
You need nothing...