60
1300000000400000
0000000013070000
4000000000000013
0113010000000000
0000000000000000
0000000000000000
0000000000000000
0000001100000000
-1827012567
1
0
1
1
1
1
0
0
Your tiles aren't immortal