60
0101010101010101
0101010101010101
0144424145440101
0142464241420101
0143444140460101
0144454041430101
0101010101010101
0101010101010101
-1827012567
0
0
1
1
1
0
1
-1
The pit