90
4041420000000000
0707071200000000
0000000712000000
0000000000000000
0000000000001300
0000000000000700
0000000000000700
0000000000110700
-1827012567
0
0
0
0
0
0
0
-1
