40
4000000000000040
4100000000000041
4000000000000040
0000000000000041
0000000000000040
0000000000000041
0000000000000040
0000000000000041
41
0
0
0
0
0
0
0
0
Little tricky