90
0000444244000000
0000424442000000
0000444144000000
0000411241000000
0000004100000000
0000000000000000
0008000000090000
0007111111070000
-1827012567
0
0
0
0
0
0
0
-1
