120
4100000000000040
4000490000490041
4100510049475140
4000015147510141
4100014751470140
4000475101514741
4149510101015140
4051010101010141
-1827012567
0
0
0
0
0
0
0
-1
First blood