40
4040404140414040
4141000000004141
0000000101000000
0000010101010000
0000000000000000
0000000000000000
0001000000000100
0000000000000000
0
0
0
1
1
1
0
0
0
No challenge