30
0000410141000000
0000000100000000
0000010100000000
0000000000000000
0000010100000000
0000000100000000
0000000100000000
0000000100000000
100000000
1
0
1
1
1
0
0
0
Let's build!