120
0000000000000000
0000000000000000
0040414243444500
0045404142434400
0044454041424300
0043444540414200
0042434445404100
0041424344454000
-615115920
0
0
1
1
1
0
0
0
It's really simple