45
0140000040000040
0100000000000000
0100000000000000
0101010100010101
0140000000000040
0100000000000000
0100000000000000
0101010101010101
1060142773
0
0
1
1
1
0
0
