120
0000000000000000
0043000000000000
0040490000000000
0049404900000000
0044434049000000
0045444940490000
0042434445404900
0045424344494000
770371504
1
0
1
1
1
0
0
0
Start thinking