45
4747474747474747
0100000000000001
0101000000000101
0101010000010101
0101010100000000
4700000000000000
0101010100010000
0101010100010100
1059142772
1
0
1
1
1
0
0
