90
0000000049000749
0101010101000700
0101010101000700
0000000000090000
0000000003490000
0000000301070000
0707070707070000
0000000000000000
0
1
0
1
1
1
0
0
0
If you don't know what these are, see help!