9999
0000000000000000
4847465051400000
4042414344450000
0101010101010101
0000000000000000
0000000000000000
4344450001414200
4041420001404300
-1827012567
-1
-1
0
0
0
-1
-1
-1
n