11111111111111111111111111111111111111111111111111
11111111100000000000000000000000000000000111111111
11111111101111111111111111111111101111110111111111
11111111100001000100010001000000101000010111111111
111111111d1101010101010101011110101101010111111111
11111111111101010101010101000010101001010111111111
11111111100001010101010101111010101011010111111111
11111111101111010101010101000010101001010111111111
11111111100001010101010101011110101101010111111111
11111111111101010101010101000010101001010111111111
11111111100001010101010101111010101011010111111111
11111111101111010101010101011010111001010111111111
111111111000000100010001010000100000d1000111111111
11111000111111111111111101011111111111111100011111
111110A000000000000000000100000000000000000T011111
11111000111111111111111101011111111111111100011111
11111111100000000000000101000000000000000111111111
11111111101111111111110101011111111111110111111111
11111111101000000000010101000001d01000000111111111
11111111101011111111010101000001000000000111111111
11111111101010000001010101010011111110000111111111
11111111101010111101010101010000001000000111111111
111111111010101d0001010101010000001000000111111111
11111111101010111111010101010000000001100111111111
11111111101010000000010101010001000001000111111111
11111111101011111111110101010011110001000111111111
11111111101000000000000101010000000000010111111111
11111111101111111111111101010011111110110111111111
11111111100000000000000000000000000000000111111111
11111111111111111111111111111111111111111111111111