00000000000000000000000000000000000000000000000000
00000000000000000000000000000000000000000110000000
00000000000000000000000000000000110110000110000000
00000000000000000000000000000000110110000110000000
00000000000000000000000000000000110110000110000000
00020000000000000000000000000000110110000110000000
00000000000000000000000000000000110110000110000000
00000000000000000000000000000000110110000110000000
00000000000000000001111111110000110110000110000o00
00000000000000000001d00000010000110110000110000d00
00000000000000000001111111010000110110000110000000
00°00000000000000001000000010000110110000110000000
d0000000000000000001011111110000110110000110000000
11101111111111111111011111111111110111111111111111
0000000000000000000101000000000011011000T11od00000
00°00000000000000001010000000000110110000110000000
00000000000000000001010000000000110110000110000000
00000000000000000001010000000000110110000110000000
00000000000000000001010000000000110110000110000000
00000000000000000001010000000000110110000110000000
00000000000000000001010000000000110110000110000000
00000000000000000111010000000000110110000110000000
0000000000000000000001000000000011d110000110000000
00000000000000000111110000000000111110000110000000
00000000000000000000000000000000000000000110000000
00000000000000000000000000000000000000000110000000
00000000000000000000000000000000000000000110000000
00000000000000000000000000000000000000000110000000
00000000000000000000000000000000000000000110000000
A0000000000000000000000000000000000000000000000000