11111111111111111111111111111111111111111111111111
1220000000000000000000221d1000000000000000000000T1
10020000200000000200000010100000000000000000000001
10002222000000000000000010100000000000000000000001
10000000020202002022020010100000000000000000000001
10000000002200022200000010100000000000000000000001
10000020002020200000000010100000000000000000000001
10000200000000220002000010100000000000000000000001
10002002000002000000200010100000000000000000000001
10020000220000200000020010100000000000000000000001
10000000000000000000002010100000000000000000000001
12200000000000000000000000000000000000000000000001
11111111111111111111111004001111111111111111111111
1d00000000000000000000004A4000000000000000000000d1
11111111111111111111111004001111111111111111111111
10000000000000000000000000000000000000000002000001
10000000000000000000000010102000000000000020000001
10000000000000000000000010100000200002222222200001
10000000000000000000000010100200000000000200020001
10000000000000000000000010100000020020000000002001
10000000000000000000000010100000000200000000200001
10000000000000000000000010100000220000002000000221
10000000000000000000000010100000000000020000020001
10000000000000000000000010100000002000000000000001
10000000000000000000000010100200022020200000000001
10000000000000000000000010100022200000000000000001
10000000000000000000000010100222000000000000000001
10000000000000000000000010102000220000000000002221
1d000000000000000000000010120000000000000000000001
11111111111111111111111111111111111111111111111111