A00000D000000000000000000000000000210000000000000K
00111110000000000000000000000000000200000000000000
01100000000000000000000000000000000220000000000000
00100000000000000000000000000000002020000000000000
10100000000000000000000000000000000012022001000200
K0100000000000000000000000000000000000100012002100
11100000000000000000000000000000000001022202201000
00000000000000000000000000000000000000212120100010
00000000000000000000000000000000000000020200010201
00000000000000000000000000000000000000001000002002
00000000000000000000000000000000000000000000000000
00000000000000000000000000000000000000000000000000
00000000000000000000000000000000000000000000000000
00000000000000000000000000000000000000000000000000
00000000000000000000000000000000000000000000000000
00000000000000000000000000000000000000000000000000
00000000000000000000000000000000000000000000000000
00000000000000000000000000000000000000000000000000
00000000000000000000000000000000000000000000000000
00000000000000000000000000000000000000000000000000
00000020202000000000000000000000000000000000000000
00000200000020000000000000000000000000000000000000
20000000022200000000000000000000000000000000000000
00220000002000000000000000000000000000000000000000
02020000022000000000000000000000000000000000000000
20002002002000000000000000000000000000000000000000
00000020000222000000000000000000000000000000000000
00000000000000200000000000000000000000000000000000
00000000000000200000000000000000000000111111111111
dddd0000000002220000000000000000000000D0000000000T