A0000000000002000000200020000000000000020000000000
00020002000000200020000000200002000002000200002020
00000000000200020000000200000200002000000000200000
11111111111111111111111111111111111111111011111110
M0000000000000000000000000000000000000000000000000
11011111111111111111111111111111111111111011111111
1000000000000000000000000000000000000000000000000M
11111111111111111111111111111111111111111111111011
1000000000000000000000000000000000000000000d0M1000
10111111111111111111111111111111111111111111011000
10000000000000000000000000000000000000200000000000
10000000000000000000000000000000000000000000000000
10000000000000000000000000000000000000000000000000
10000000000000000000000000000000000000000000000000
10000000000000000000000000000000000000000000000000
10000000000000000000000000000000000000000000000000
10000000000000000000000000000000000000000000000000
10000000000000000000000000000000000000000000000000
10000000000000000000000000000000000000000000000000
10000000000000d00000000000000000000000000000001111
100000000000004d0000000000000000000001000000001000
10000000000001010000000000000000000000000000001010
10000000000001010000000000000000000000000000001010
10000000000001010000000000000000000000000000001010
10000000000001010000000000000000000000000000001010
M000000000000000000000000000000000000000000000101d
10000000000001010000000000000000000010000000001010
10000000000000000000000000000000000000000000001010
10000000000000000000000000000000000000000000000010
M000000000000000000000000000000000000000000000000T