11111111111111111111111111111111111111111111111111
1KKKKKKKKKKKKKKKKKKKKKKKKKKKKKKKKKKKKKKKKKKKKKKKK1
1K1111111111111111111111111111111111111111111111K1
1K1Kd0000000000000001000000000000000000000010001K1
1K1110000000000000001010000000000000000000010001K1
1K100000000000000000101000000000000000000001d001K1
1K1000000000000000001o1000000000000000000001K001K1
1K100000000000111111101000000000000000000001K001K1
1K1000000000001M000000100000000000000000000111D1K1
1K1000000000001111111010000000000000000000000001K1
1K1000000000000000001010000000000000000000000001K1
1K1000000000000000001o11111100000000000000000001K1
1K1000000000000000001010000100000000000000000001K1
1K1000000000001111111000000100000000000000000001K1
1K1D10000000001M0000001000A100000000000000000001K1
1K1D10000000001111111011111100000000000000000001K1
1K1010000000000000001010000D00000000000000000001K1
1K1010000000000000001010000100000000000000000001K1
1K1010000000001111111o1111d100000000000000000001K1
1K1K10000000001M0000001d111100000000000000000001K1
1K1K10000000001111111010000100000000000000000001K1
1K1K10000000000000000010000D00000000000001111101K1
1K1d10000000000000011111111111111111111111000001K1
1K11111111111111111100DDD00000000000000000000001K1
1K1MT0000000000000000d11100000000000000000000001K1
1K1000000000000000000210000000000000000000011001K1
1K100000000000000000001000000000000000000001M001K1
1K1111111111111111111111111111111111111111111101K1
1KKKKKKKKKKKKKKKKKKKKKKKKKKKKKKKKKKKKKKKKKKKKKKKK1
11111111111111111111111111111111111111111111111111