<<<<100000
0000010000
0000001000
0000000100
0000000010
0000:?4>01
0000000010
0000000100
0000001000
====010000
90