4000000000
0000000000
0002000200
0000000000
0200020002
0000000000
1010101010
A1B1>1?1C1
1@1?131>1;
9191919191
:0