1919191919
0000000000
0?000000?0
0000000000
0000000000
2C204000B0
0000000000
0?000000?0
0000000000
9191919191
:0