\               / 
 \             /  
  \ _________ /   
   |    _    |    
   |   | |   |    
   |___| |___|    
  /           \   
 /             \  
/               \ 
