\               /
 \             /
  \ _________ /
   |         | /|
   |         | ||
   |_________| ||
  /           \||
 /              |
/                \
