 \               /
  \             /
   \ _________ /
 |\ |         | /|
 || |         | ||
 || |_________| ||
 ||/           \||
 |               |
/                 \
