 \               /
  \             /
   \ _________ /
 |\ |    _    | /|
 || |   | |   | ||
 || |___| |___| ||
 ||/           \||
 |               |
/                 \
