size 7x8
1 1 1 1 1 1 1 0
1 2 2 4 2 2 1 0
1 2 3 2 1 2 1 1
1 4 1 3 2 3 2 1
1 2 2 4 1 6 2 1
1 2 2 2 1 2 2 1
1 1 1 1 1 1 1 1