/* Dallas levels */

"l1",
	1,0,2,	17,5,400,		16,5,520,		16,5,740,
"l2",
	3,3,0,	16,5,400,		14,5,520,		14,5,740,
"l3",
	1,1,3,	19,4,380,		17,4,470,		17,4,660,
"l4",
	2,2,2,	17,6,450,		15,6,550,		15,6,700,
"l5",
	3,0,4,	16,7,450,		14,7,520,		14,7,740,
"l6",
	2,2,1,	19,5,500,		18,5,570,		18,5,730,
"l7",
	3,1,4,	19,6,500,		19,6,550,		18,6,730,
"l8",
	2,3,0,	21,6,475,		20,6,520,		20,6,730,
"l9",
	0,0,1,	19,6,450,		18,6,580,		17,6,760,
"l10",
	1,1,0,	19,7,425,		18,7,520,		17,7,730
end
