0,5,35
00000110000
00121110000
00122220000
00001010000
01122010000
12221010000
00012110000
00001000000
00001011110
00001011121
0000111112e
