5,5,31
00000000110
00000e23210
00000101000
00111100000
00111221110
00013541011
00000010012
00000010011
00000021120
00000010010
00000011110
