1,0,39
3e222222222
20000000002
20000000002
20000000002
20000000002
20000000002
20000000002
20000000002
20000000002
20000000002
22222222222
