10,10,27
00000000000
00011000000
00012110000
00001011100
12221011200
00011011200
00101010000
0e311120000
00100010100
00000011210
00000000011
