10,5,23
00000011100
00000010100
00000011200
00000010111
00011010112
e1132010003
00011221102
00000111101
00000000000
00000000000
00000000000
