5,10,29
0111111111e
01231000000
00121000000
00112111000
00111101000
00000211000
00000100000
00000100000
00011221000
00011111000
00012321000
