5,0,29
00000100000
00000100000
00011212100
00011212100
00011112100
00011112100
00011111100
00000010100
00e11252100
00000010000
00000000000
