0,0,29
10000000000
12300000000
00200000000
00343000000
00004500000
00000430000
00000031100
00000021100
000e1111100
00000000000
00000000000
