10,0,40
00011111212
00010000102
01121111112
01110000e01
01232332101
00010212101
00010112101
00010001101
00010000001
11121000001
11122111111
