0,10,27
0000000000e
00000011222
00000121000
00000111000
00000100000
00111110000
00133121000
00010000000
01111110000
12101010000
11112110000
