10,5,25
00010000000
e1350001000
00020125310
00110112111
00111111001
00000000122
00000000111
00000000111
00000000000
00000000000
00000000000
