1,10,25
00000000000
00000000000
00001100100
00002211200
00001100100
00001211100
01100101100
12211211200
10000000200
12100000100
13100001e10
