10,9,35
00000000001
00001000002
0001e210002
00010000002
00122100002
00123100002
00001000002
00001111212
00000011223
00000011123
00000001111
