4,5,35
00000111000
00000101000
01111201000
01111301000
01111401000
01111523000
01111302000
0111120221e
01111101100
00000000000
00000000000
