0,2,24
00000000000
00111000000
11331000000
00131111000
00011101000
00000001000
00000001000
01000021000
13111440000
01001200000
0e000000000
