10,0,33
00000000111
00000000200
00000012300
00000122100
00000111100
0000e000100
00005000100
00114541100
00101000000
00101100000
00111100000
