5,10,33
11000000000
11011110000
11011110000
1e233210000
11111000000
00001000000
00112222110
00101101010
00112212110
00101101010
00111101110
