0,0,35
10111110000
21111220000
11010110110
01031231110
01120010110
00000022110
00000011110
00000420000
00122400000
00120000000
e1110000000
