0,0,30
53100000000
40000000000
42100000000
21100000000
11210111121
00210111121
00111111121
00000000011
00000000001
00000000001
0000000000e
