5,5,33
11111100000
23111200000
23000200000
11000200000
11111200000
00001e00000
00001200000
00000200011
00000200021
00000211121
00000111111
