4,2,22
00000000000
00000000000
000010111e0
00001010000
01112121100
01001010100
01001121100
01111110000
00000000000
00000000000
00000000000
