0,10,30
00000000000
00000000000
00011110000
00011110000
00011210100
00011211310
00000100100
11110100100
11110101410
12110100200
1101110011e
