5,5,41
00200000020
02521110141
01000010111
11011122101
11010002111
12010112000
12010001000
01011112230
01000001020
01111111010
0000000001e
