0,0,31
22210000000
11100110000
11123210000
11000221100
11000210100
11000111100
11000100000
11000111000
11000111000
11000100000
11000e00000
