10,5,29
01111111000
13000101000
02011211000
01011111000
01e11111000
01011122221
01011111000
01011111000
01110000000
00000000000
00000000000
